CellId	CellType
mixed_AAACATACAGCTAC	293t
mixed_AAACATTGTAAGGA	jurkat
mixed_AAACCGTGGCGTAT	jurkat
mixed_AAACGCACTACTGG	jurkat
mixed_AAACGCTGAAGATG	jurkat
mixed_AAACGCTGCGCATA	293t
mixed_AAACGGCTCTGGAT	jurkat
mixed_AAACGGCTTCGCTC	jurkat
mixed_AAACGGCTTGCCCT	jurkat
mixed_AAACTTGAAAGAAC	293t
mixed_AAACTTGAAGCCAT	293t
mixed_AAACTTGAGTCTTT	jurkat
mixed_AAAGACGACTCAAG	jurkat
mixed_AAAGACGATATCGG	293t
mixed_AAAGAGACACTGTG	293t
mixed_AAAGAGACTGGTGT	293t
mixed_AAAGATCTCATTTC	293t
mixed_AAAGATCTCTTATC	293t
mixed_AAAGATCTCTTGAG	jurkat
mixed_AAAGATCTGCGTAT	jurkat
mixed_AAAGATCTGCGTTA	jurkat
mixed_AAAGCAGAATTGGC	jurkat
mixed_AAAGCCTGCCTATT	jurkat
mixed_AAAGCCTGGCAAGG	jurkat
mixed_AAAGCCTGTCACGA	jurkat
mixed_AAAGGCCTAACCTG	293t
mixed_AAAGTTTGCTGACA	293t
mixed_AAAGTTTGCTTGAG	jurkat
mixed_AAAGTTTGGGAAAT	jurkat
mixed_AAATACTGAAAGCA	jurkat
mixed_AAATACTGACACAC	jurkat
mixed_AAATACTGCCCTTG	293t
mixed_AAATACTGGAAGGC	jurkat
mixed_AAATACTGGAGAGC	jurkat
mixed_AAATACTGGTGTTG	jurkat
mixed_AAATACTGTTCTGT	jurkat
mixed_AAATCAACACCGAT	293t
mixed_AAATCAACCTCCAC	293t
mixed_AAATCAACTCAGGT	293t
mixed_AAATCAACTCTCTA	293t
mixed_AAATCATGCTCGAA	293t
mixed_AAATGGGAACCAGT	jurkat
mixed_AAATGGGACTTGGA	293t
mixed_AAATGGGAGAATCC	293t
mixed_AAATGGGAGCTAAC	jurkat
mixed_AAATGGGATTCATC	293t
mixed_AAATGTTGACCCTC	jurkat
mixed_AAATGTTGACTTTC	jurkat
mixed_AAATGTTGCTGAAC	293t
mixed_AAATGTTGGAGATA	jurkat
mixed_AAATGTTGTGCCCT	293t
mixed_AAATGTTGTTGCGA	293t
mixed_AAATTCGACACTCC	293t
mixed_AAATTCGACATACG	jurkat
mixed_AAATTGACATCACG	293t
mixed_AAATTGACTAGCCA	293t
mixed_AACAAACTCGACAT	293t
mixed_AACAAACTCTGGTA	jurkat
mixed_AACAAACTGAATGA	293t
mixed_AACAAACTGTGCAT	jurkat
mixed_AACAAACTTCGACA	293t
mixed_AACAATACAACGTC	jurkat
mixed_AACAATACCAAGCT	jurkat
mixed_AACAATACTAACCG	293t
mixed_AACAATACTCCAAG	293t
mixed_AACAATACTCGATG	293t
mixed_AACACGTGACTGGT	jurkat
mixed_AACACGTGCTCGCT	293t
mixed_AACACGTGGAGGCA	jurkat
mixed_AACACGTGTACGCA	293t
mixed_AACACGTGTTCGGA	293t
mixed_AACACTCTTAGCCA	293t
mixed_AACAGAGAATCTTC	jurkat
mixed_AACAGAGATACTTC	jurkat
mixed_AACAGAGATGCACA	293t
mixed_AACAGCACAGTGCT	293t
mixed_AACAGCACCCTAAG	jurkat
mixed_AACAGCACCGTGTA	jurkat
mixed_AACAGCACTCTCGC	jurkat
mixed_AACATATGACGTTG	293t
mixed_AACATATGCTTACT	293t
mixed_AACATATGTCGTGA	jurkat
mixed_AACATATGTGCTGA	jurkat
mixed_AACATTGAGCCATA	jurkat
mixed_AACATTGAGGGCAA	293t
mixed_AACATTGATCCTGC	293t
mixed_AACCACGACTTGAG	jurkat
mixed_AACCACGATCCGAA	jurkat
mixed_AACCCAGAGACTAC	jurkat
mixed_AACCGATGAAAACG	293t
mixed_AACCGATGCTTCGC	293t
mixed_AACCGATGGCCAAT	jurkat
mixed_AACCGATGTATCTC	293t
mixed_AACCGATGTTGTCT	jurkat
mixed_AACCGCCTATTCGG	293t
mixed_AACCGCCTGTAAAG	293t
mixed_AACCGCCTGTATGC	jurkat
mixed_AACCGCCTTAGTCG	jurkat
mixed_AACCTTACCCCTAC	jurkat
mixed_AACCTTACCTACCC	jurkat
mixed_AACCTTTGAAAGCA	jurkat
mixed_AACCTTTGAGTGCT	jurkat
mixed_AACCTTTGTGTCAG	jurkat
mixed_AACGCAACCAGAAA	jurkat
mixed_AACGCAACGTTACG	293t
mixed_AACGCAACTTCAGG	293t
mixed_AACGCATGTGAGAA	293t
mixed_AACGCCCTACACGT	jurkat
mixed_AACGGTACGGAAAT	jurkat
mixed_AACGGTACTCAAGC	jurkat
mixed_AACGGTACTGTCTT	jurkat
mixed_AACGGTACTTCATC	293t
mixed_AACGGTTGAATCGC	jurkat
mixed_AACGGTTGGGGCAA	293t
mixed_AACGTCGAAACCTG	jurkat
mixed_AACGTCGAACACTG	jurkat
mixed_AACGTGTGAGTGTC	jurkat
mixed_AACGTGTGATGACC	293t
mixed_AACGTGTGCCCTAC	jurkat
mixed_AACGTGTGCGTTGA	293t
mixed_AACGTGTGTCGCTC	jurkat
mixed_AACGTGTGTTACTC	293t
mixed_AACGTTCTTCCGAA	jurkat
mixed_AACGTTCTTTGAGC	jurkat
mixed_AACTACCTAGACTC	jurkat
mixed_AACTACCTAGAGGC	jurkat
mixed_AACTACCTCACTGA	jurkat
mixed_AACTACCTCTTGAG	jurkat
mixed_AACTCACTTCCCAC	293t
mixed_AACTCGGAACCACA	jurkat
mixed_AACTCGGAGCGATT	jurkat
mixed_AACTCTTGACACTG	293t
mixed_AACTCTTGATGACC	293t
mixed_AACTCTTGCGAGAG	293t
mixed_AACTCTTGTCGCAA	293t
mixed_AACTGTCTCAATCG	jurkat
mixed_AACTTGCTGTATGC	jurkat
mixed_AACTTGCTTCTCCG	jurkat
mixed_AACTTGCTTGGTTG	293t
mixed_AAGAACGATCACCC	293t
mixed_AAGAAGACAAAGCA	293t
mixed_AAGAAGACACTTTC	293t
mixed_AAGAAGACGGAGTG	jurkat
mixed_AAGAAGACTTTACC	293t
mixed_AAGAATCTATGACC	293t
mixed_AAGAATCTCGACTA	jurkat
mixed_AAGAGATGCGTGTA	jurkat
mixed_AAGATGGAGCATAC	jurkat
mixed_AAGATTACATAAGG	293t
mixed_AAGATTACATTCGG	293t
mixed_AAGATTACCTAGTG	293t
mixed_AAGATTACTGCCTC	jurkat
mixed_AAGCAAGAAATCGC	jurkat
mixed_AAGCAAGACCCTCA	293t
mixed_AAGCCAACCAATCG	293t
mixed_AAGCCATGAACCTG	jurkat
mixed_AAGCCATGACTCTT	293t
mixed_AAGCCATGCTGTTT	jurkat
mixed_AAGCCTGAACCTGA	jurkat
mixed_AAGCGACTAAAAGC	293t
mixed_AAGCGTACGTGTTG	jurkat
mixed_AAGCGTACTCTGGA	293t
mixed_AAGGCTACTTACTC	jurkat
mixed_AAGGTCACAAGGGC	jurkat
mixed_AAGGTCACTGAAGA	293t
mixed_AAGGTCTGGCCCTT	293t
mixed_AAGGTGCTCAACTG	jurkat
mixed_AAGGTGCTGCTGAT	293t
mixed_AAGGTGCTGTAGGG	jurkat
mixed_AAGGTGCTTACTGG	293t
mixed_AAGTAACTAGCCTA	293t
mixed_AAGTAACTGATAAG	293t
mixed_AAGTAACTTATCGG	293t
mixed_AAGTAGGACATCAG	293t
mixed_AAGTAGGACGAACT	jurkat
mixed_AAGTATACCCAACA	293t
mixed_AAGTATACGAGGCA	jurkat
mixed_AAGTATACTGAGGG	293t
mixed_AAGTCCGAAATCGC	293t
mixed_AAGTCCGAAGAACA	293t
mixed_AAGTCCGACTGTCC	jurkat
mixed_AAGTCCGATCAGTG	jurkat
mixed_AAGTCTCTAGTGTC	293t
mixed_AAGTCTCTCTTGCC	293t
mixed_AAGTCTCTTTTACC	293t
mixed_AAGTGCACAGTCTG	293t
mixed_AAGTGCACATGTGC	293t
mixed_AAGTGCACGGAAGC	293t
mixed_AAGTTATGGCAGAG	jurkat
mixed_AAGTTATGGCTGTA	293t
mixed_AAGTTATGTCTATC	jurkat
mixed_AAGTTATGTTCGGA	293t
mixed_AAGTTCCTCAAGCT	jurkat
mixed_AAGTTCCTCCTCCA	293t
mixed_AAGTTCCTTCCGTC	jurkat
mixed_AATAAGCTTGATGC	293t
mixed_AATACCCTAAGTGA	jurkat
mixed_AATACCCTCCGCTT	jurkat
mixed_AATACCCTGTACAC	jurkat
mixed_AATACTGAAAGTAG	jurkat
mixed_AATACTGAGCATAC	jurkat
mixed_AATACTGAGGGACA	293t
mixed_AATACTGATTCTCA	293t
mixed_AATAGGGATTCATC	jurkat
mixed_AATAGGGATTTCAC	293t
mixed_AATATCGACCCGTT	293t
mixed_AATATCGACGACTA	293t
mixed_AATATCGAGCAGTT	293t
mixed_AATCAAACGCAGTT	293t
mixed_AATCAAACGCTTAG	293t
mixed_AATCCGGACATTTC	293t
mixed_AATCCGGATGTAGC	jurkat
mixed_AATCCTACACCTAG	jurkat
mixed_AATCCTACCCCTCA	jurkat
mixed_AATCCTACGGGCAA	293t
mixed_AATCCTTGAACGGG	jurkat
mixed_AATCCTTGAACTGC	jurkat
mixed_AATCCTTGTTGCGA	293t
mixed_AATCGGTGACGCAT	293t
mixed_AATCGGTGAGTACC	jurkat
mixed_AATCGGTGCACTCC	293t
mixed_AATCGGTGCCAAGT	jurkat
mixed_AATCTAGAAGTCTG	jurkat
mixed_AATCTAGAATTGGC	jurkat
mixed_AATCTCACACCATG	jurkat
mixed_AATCTCACACCCTC	293t
mixed_AATCTCTGATCACG	jurkat
mixed_AATCTCTGCGTTGA	293t
mixed_AATGAGGACGCTAA	jurkat
mixed_AATGAGGATTTCGT	293t
mixed_AATGCGTGAACAGA	293t
mixed_AATGCGTGAAGGGC	293t
mixed_AATGCGTGATAAGG	293t
mixed_AATGCGTGGCAAGG	293t
mixed_AATGCGTGTGGTTG	293t
mixed_AATGGAGATGCATG	293t
mixed_AATGTAACAGTGCT	jurkat
mixed_AATGTAACATCGTG	293t
mixed_AATGTAACTTCCGC	jurkat
mixed_AATGTCCTAAGGCG	jurkat
mixed_AATGTCCTTTCCGC	jurkat
mixed_AATGTTGAACCTGA	jurkat
mixed_AATGTTGAAGCTCA	jurkat
mixed_AATGTTGACCACCT	293t
mixed_AATGTTGACCTACC	jurkat
mixed_AATGTTGACTGCTC	293t
mixed_AATTACGACGAATC	293t
mixed_AATTCCTGAAAGCA	jurkat
mixed_AATTGATGGTCTAG	jurkat
mixed_AATTGTGAAACCAC	293t
mixed_AATTGTGAACCTTT	293t
mixed_AATTGTGAATTTCC	jurkat
mixed_AATTGTGATGTCGA	jurkat
mixed_ACAAAGGAGGTCTA	jurkat
mixed_ACAAAGGAGTTGGT	293t
mixed_ACAAAGGATGTAGC	jurkat
mixed_ACAAATTGAACGAA	jurkat
mixed_ACAAATTGGGGATG	293t
mixed_ACAACCGACCTTGC	293t
mixed_ACAACCGAGTAGGG	293t
mixed_ACAAGAGAACGACT	293t
mixed_ACAAGAGACTCAGA	293t
mixed_ACAAGAGACTGTTT	jurkat
mixed_ACAAGAGAGCATCA	293t
mixed_ACAAGCACTCTTTG	293t
mixed_ACAAGCACTTACTC	jurkat
mixed_ACAATAACTCTCAT	293t
mixed_ACAATCCTCGTGTA	jurkat
mixed_ACAATCCTGTCCTC	293t
mixed_ACAATTGACCCTCA	jurkat
mixed_ACAATTGATTCCGC	jurkat
mixed_ACACATCTCCATAG	jurkat
mixed_ACACATCTGTGAGG	293t
mixed_ACACATCTTGGGAG	293t
mixed_ACACCCTGGAGGGT	293t
mixed_ACACCCTGGCTACA	293t
mixed_ACACGAACCTGATG	293t
mixed_ACACGAACTGTGAC	293t
mixed_ACACGATGAGCGTT	293t
mixed_ACACGATGGGTCAT	jurkat
mixed_ACACGATGTGGATC	293t
mixed_ACACGTGACACTCC	jurkat
mixed_ACACGTGAGCTAAC	293t
mixed_ACACGTGATGACCA	293t
mixed_ACAGACACCGTCTC	jurkat
mixed_ACAGACACCTCAGA	293t
mixed_ACAGCAACCCCTCA	jurkat
mixed_ACAGCAACCCGTAA	jurkat
mixed_ACAGGTACTCTTCA	293t
mixed_ACAGTCGAAGCTAC	293t
mixed_ACAGTCGAATCAGC	jurkat
mixed_ACAGTCGAATCTCT	293t
mixed_ACAGTCGATGAGAA	jurkat
mixed_ACAGTGACACTACG	jurkat
mixed_ACAGTGACATTCTC	jurkat
mixed_ACAGTGACCCCACT	293t
mixed_ACAGTGTGAACCAC	jurkat
mixed_ACAGTGTGCTGGTA	jurkat
mixed_ACAGTTCTTTTACC	jurkat
mixed_ACATACCTTGTAGC	293t
mixed_ACATCACTCACAAC	293t
mixed_ACATCACTCCTCCA	293t
mixed_ACATCACTTATGCG	293t
mixed_ACATGGTGTCTCCG	jurkat
mixed_ACATTCTGACGACT	293t
mixed_ACCAACGACGATAC	jurkat
mixed_ACCACAGAATGGTC	293t
mixed_ACCACAGACTTCCG	293t
mixed_ACCACAGAGGAAAT	293t
mixed_ACCACAGAGTTTGG	jurkat
mixed_ACCACAGATGGTAC	jurkat
mixed_ACCACAGATGTCTT	jurkat
mixed_ACCACCTGAAAACG	293t
mixed_ACCACCTGCACAAC	jurkat
mixed_ACCACCTGCCCTAC	jurkat
mixed_ACCACCTGCCCTCA	293t
mixed_ACCACCTGTGTGCA	293t
mixed_ACCACGCTAACGGG	jurkat
mixed_ACCAGCCTGAATCC	jurkat
mixed_ACCAGCCTGTTGAC	jurkat
mixed_ACCAGCCTTGGTGT	293t
mixed_ACCAGTGACTCTCG	jurkat
mixed_ACCAGTGAGCCAAT	jurkat
mixed_ACCAGTGAGTTCAG	jurkat
mixed_ACCAGTGATGCTAG	293t
mixed_ACCATTACCCAATG	293t
mixed_ACCATTACCGGAGA	293t
mixed_ACCATTACTCTCCG	293t
mixed_ACCATTACTGCCCT	293t
mixed_ACCATTTGAACCGT	jurkat
mixed_ACCATTTGCTCAAG	jurkat
mixed_ACCATTTGCTGTAG	293t
mixed_ACCCAAGAATGGTC	jurkat
mixed_ACCCAAGACTCGCT	jurkat
mixed_ACCCAAGATAACGC	jurkat
mixed_ACCCACTGAGAATG	293t
mixed_ACCCACTGCCAAGT	jurkat
mixed_ACCCAGCTAATGCC	jurkat
mixed_ACCCAGCTCCCACT	jurkat
mixed_ACCCAGCTCGAGTT	jurkat
mixed_ACCCAGCTGTGCTA	293t
mixed_ACCCGTACACCTAG	jurkat
mixed_ACCCGTACGTGTAC	293t
mixed_ACCCGTTGACACCA	293t
mixed_ACCCGTTGAGCGGA	293t
mixed_ACCCGTTGCTATGG	293t
mixed_ACCCGTTGGAGAGC	jurkat
mixed_ACCCGTTGGGATTC	293t
mixed_ACCCGTTGTAACGC	293t
mixed_ACCCTCGACATGGT	293t
mixed_ACCCTCGAGACGAG	293t
mixed_ACCGAAACACACAC	jurkat
mixed_ACCGAAACGAATGA	jurkat
mixed_ACCGAAACTAAGCC	293t
mixed_ACCGAAACTCCCAC	293t
mixed_ACCGAAACTGCATG	293t
mixed_ACCGCGGAATCAGC	293t
mixed_ACCGCGGACAGAGG	jurkat
mixed_ACCGCGGATGACAC	293t
mixed_ACCGCGGATGGCAT	jurkat
mixed_ACCGCGGATTGAGC	293t
mixed_ACCGTGCTGGATTC	293t
mixed_ACCGTGCTGTAAGA	293t
mixed_ACCTATTGGTTCGA	jurkat
mixed_ACCTCCGAAAGGCG	293t
mixed_ACCTCCGAAGCGGA	jurkat
mixed_ACCTCCGACGAATC	293t
mixed_ACCTCGTGAACGAA	jurkat
mixed_ACCTCGTGGGCATT	293t
mixed_ACCTCGTGTCGTGA	293t
mixed_ACCTCGTGTGCATG	293t
mixed_ACCTGGCTACGCTA	293t
mixed_ACCTGGCTCGACTA	293t
mixed_ACCTGGCTTATCGG	293t
mixed_ACCTGGCTTGCCTC	293t
mixed_ACCTGGCTTGTGGT	jurkat
mixed_ACCTTTGAAAAAGC	293t
mixed_ACCTTTGAACACTG	293t
mixed_ACGAACACTGAAGA	jurkat
mixed_ACGAACTGCTGTGA	293t
mixed_ACGAACTGTGCTGA	jurkat
mixed_ACGAACTGTTGAGC	jurkat
mixed_ACGAAGCTTCCAAG	jurkat
mixed_ACGAAGCTTGTCAG	293t
mixed_ACGACAACGAACCT	jurkat
mixed_ACGACAACGCCTTC	293t
mixed_ACGACAACTTGAGC	jurkat
mixed_ACGACCCTAACGTC	293t
mixed_ACGACCCTCTGCTC	293t
mixed_ACGACCCTGGAGGT	293t
mixed_ACGACCCTTAAGCC	jurkat
mixed_ACGACCCTTCAGAC	293t
mixed_ACGACCCTTGCAAC	293t
mixed_ACGACCCTTTGCGA	jurkat
mixed_ACGAGTACCTGAGT	jurkat
mixed_ACGAGTACGTCATG	293t
mixed_ACGAGTACTGCAGT	293t
mixed_ACGAGTACTTTACC	jurkat
mixed_ACGATCGACGAGAG	jurkat
mixed_ACGATCGATGCTGA	293t
mixed_ACGATGACATAAGG	jurkat
mixed_ACGATGACGAGAGC	293t
mixed_ACGATTCTAGCCAT	jurkat
mixed_ACGATTCTATGCCA	jurkat
mixed_ACGATTCTGGTACT	293t
mixed_ACGATTCTTAGCGT	jurkat
mixed_ACGCAATGCCTTAT	293t
mixed_ACGCAATGTATCTC	293t
mixed_ACGCAATGTCTTAC	jurkat
mixed_ACGCACCTACCAAC	293t
mixed_ACGCCACTAACTGC	jurkat
mixed_ACGCCACTAAGGCG	jurkat
mixed_ACGCCACTCCTTTA	293t
mixed_ACGCCACTGGAGTG	jurkat
mixed_ACGCCACTGTTCTT	jurkat
mixed_ACGCCGGAACAGCT	jurkat
mixed_ACGCCGGACGGGAA	293t
mixed_ACGCCGGACTCGAA	jurkat
mixed_ACGCCGGATGGAGG	293t
mixed_ACGCCTTGCGATAC	293t
mixed_ACGCCTTGTTTACC	293t
mixed_ACGCGGTGATAAGG	jurkat
mixed_ACGCGGTGGTCTTT	jurkat
mixed_ACGCTGCTACCTCC	jurkat
mixed_ACGCTGCTTGTCTT	293t
mixed_ACGGAACTAGGTCT	jurkat
mixed_ACGGAACTCATTTC	jurkat
mixed_ACGGAACTCCTAAG	293t
mixed_ACGGAACTTAGCCA	293t
mixed_ACGGAACTTGCATG	293t
mixed_ACGGATTGGAAGGC	jurkat
mixed_ACGGATTGGGGTGA	jurkat
mixed_ACGGATTGGGTTAC	293t
mixed_ACGGATTGTATTCC	jurkat
mixed_ACGGATTGTTAGGC	jurkat
mixed_ACGGCTCTACTCAG	293t
mixed_ACGGCTCTGATAAG	293t
mixed_ACGGGAGAACGACT	jurkat
mixed_ACGGGAGAGACAAA	293t
mixed_ACGGGAGATCCGAA	jurkat
mixed_ACGGTAACAAAAGC	jurkat
mixed_ACGGTAACCATCAG	jurkat
mixed_ACGGTAACGGAAGC	293t
mixed_ACGGTAACGTGTCA	293t
mixed_ACGGTAACTACAGC	293t
mixed_ACGGTAACTTATCC	293t
mixed_ACGGTATGAACGGG	jurkat
mixed_ACGGTATGTGCTCC	293t
mixed_ACGGTATGTGGGAG	293t
mixed_ACGTAGACCGCATA	jurkat
mixed_ACGTAGACTGTCGA	jurkat
mixed_ACGTCAGAAGTCAC	293t
mixed_ACGTCAGATCTCTA	293t
mixed_ACGTCAGATGACAC	293t
mixed_ACGTCCTGGAAAGT	jurkat
mixed_ACGTCGCTACGGAG	293t
mixed_ACGTCGCTCAGTCA	293t
mixed_ACGTCGCTTTATCC	jurkat
mixed_ACGTGATGATTCCT	jurkat
mixed_ACGTGCCTAGATCC	jurkat
mixed_ACGTGCCTCCTCCA	293t
mixed_ACGTGCCTCGTTGA	jurkat
mixed_ACGTGCCTGTAAGA	jurkat
mixed_ACGTTACTCGTTAG	jurkat
mixed_ACGTTACTGATAAG	jurkat
mixed_ACGTTGGACTGCTC	jurkat
mixed_ACGTTGGATCACCC	jurkat
mixed_ACGTTGGATCGCAA	293t
mixed_ACGTTGGATGTCCC	293t
mixed_ACGTTTACCTGGAT	293t
mixed_ACGTTTACGGAGTG	jurkat
mixed_ACTAAAACTGGAAA	jurkat
mixed_ACTACTACCTGAAC	jurkat
mixed_ACTACTACGGAACG	jurkat
mixed_ACTAGGTGGAATAG	jurkat
mixed_ACTAGGTGGGTAAA	jurkat
mixed_ACTATCACAGCCAT	jurkat
mixed_ACTATCACGGTAGG	293t
mixed_ACTCAGGAGGTCTA	jurkat
mixed_ACTCAGGATTCTGT	jurkat
mixed_ACTCCCGACCTATT	jurkat
mixed_ACTCCCGAGAAACA	jurkat
mixed_ACTCCTCTCTATGG	293t
mixed_ACTCCTCTGACGTT	jurkat
mixed_ACTCGAGAAACTGC	jurkat
mixed_ACTCGCACGCTGAT	jurkat
mixed_ACTCGCACGGACAG	jurkat
mixed_ACTCGCACTGCAAC	jurkat
mixed_ACTCGCACTTTCTG	jurkat
mixed_ACTCTATGCTATTC	293t
mixed_ACTCTATGGAACTC	jurkat
mixed_ACTCTATGTGCAGT	293t
mixed_ACTCTCCTCGCTAA	jurkat
mixed_ACTGAGACACACAC	jurkat
mixed_ACTGAGACTACTTC	jurkat
mixed_ACTGCCACAAGCAA	293t
mixed_ACTGCCACCATGAC	jurkat
mixed_ACTGCCACTCTCAT	jurkat
mixed_ACTGCCTGATCTTC	jurkat
mixed_ACTGTGGAGCGTTA	293t
mixed_ACTGTGGAGTCAAC	293t
mixed_ACTGTGGATTCCAT	jurkat
mixed_ACTGTTACGACTAC	jurkat
mixed_ACTTAAGATCTCTA	293t
mixed_ACTTAGCTATACCG	293t
mixed_ACTTAGCTCAAGCT	jurkat
mixed_ACTTCAACGAGCAG	jurkat
mixed_ACTTCAACGATAAG	jurkat
mixed_ACTTCAACGTACAC	293t
mixed_ACTTCAACTGATGC	jurkat
mixed_ACTTCAACTTCTAC	293t
mixed_ACTTCCCTAAAGCA	jurkat
mixed_ACTTCTGAACCGAT	293t
mixed_ACTTCTGATCTCCG	jurkat
mixed_ACTTGACTATCGGT	jurkat
mixed_ACTTGACTGAAACA	293t
mixed_ACTTGGGAGCTGTA	293t
mixed_ACTTGGGAGTTCTT	jurkat
mixed_ACTTGTACCCTACC	293t
mixed_ACTTGTACCGTACA	jurkat
mixed_ACTTTGTGCAGCTA	jurkat
mixed_ACTTTGTGGATAGA	jurkat
mixed_ACTTTGTGTCTTTG	jurkat
mixed_AGAAACGAAAACGA	293t
mixed_AGAAACGACCTCCA	293t
mixed_AGAAACGACTAGTG	293t
mixed_AGAAAGTGACACGT	jurkat
mixed_AGAAAGTGACTAGC	293t
mixed_AGAAAGTGGCGATT	293t
mixed_AGAAAGTGGTCCTC	jurkat
mixed_AGAAAGTGTAACGC	jurkat
mixed_AGAAAGTGTGCATG	293t
mixed_AGAACAGAGGGTGA	jurkat
mixed_AGAACAGATCTGGA	jurkat
mixed_AGAACAGATTTGGG	293t
mixed_AGAACGCTTGCAAC	293t
mixed_AGAAGATGTTGGTG	jurkat
mixed_AGAATACTAGGAGC	jurkat
mixed_AGAATACTCAGTCA	293t
mixed_AGAATACTCCACCT	jurkat
mixed_AGAATACTCCCTTG	jurkat
mixed_AGAATGGATTCTTG	293t
mixed_AGAATTTGAAAAGC	293t
mixed_AGAATTTGAGTCAC	293t
mixed_AGAATTTGCGAGAG	jurkat
mixed_AGAATTTGTGCCTC	jurkat
mixed_AGACACACACGCAT	jurkat
mixed_AGACACACATCGAC	293t
mixed_AGACACACCGATAC	jurkat
mixed_AGACACACGCTTCC	jurkat
mixed_AGACACACGTGCTA	293t
mixed_AGACACTGCCGAAT	293t
mixed_AGACACTGTCAGTG	293t
mixed_AGACACTGTGGATC	293t
mixed_AGACCTGACAATCG	293t
mixed_AGACGTACTGCTGA	jurkat
mixed_AGACGTACTGTTTC	jurkat
mixed_AGACTCGATGATGC	jurkat
mixed_AGACTGACAAGTAG	293t
mixed_AGACTTCTCCTGTC	293t
mixed_AGAGAAACACGGAG	jurkat
mixed_AGAGAAACCGGAGA	293t
mixed_AGAGAAACCGTAGT	293t
mixed_AGAGAAACGAACCT	jurkat
mixed_AGAGAAACGTTGCA	jurkat
mixed_AGAGAATGCTTGTT	jurkat
mixed_AGAGAATGTACTGG	293t
mixed_AGAGATGAACGGTT	jurkat
mixed_AGAGCGGAGCTATG	jurkat
mixed_AGAGCTACACGGAG	jurkat
mixed_AGAGCTACCGTCTC	293t
mixed_AGAGCTACTGCATG	293t
mixed_AGAGGTCTCGAATC	293t
mixed_AGAGGTCTCGTGTA	293t
mixed_AGAGGTCTTCCTCG	293t
mixed_AGAGTCACACGGGA	jurkat
mixed_AGAGTCACGGCGAA	jurkat
mixed_AGAGTCTGAACCGT	jurkat
mixed_AGAGTGCTCTTGTT	293t
mixed_AGATATACGAACCT	293t
mixed_AGATATTGCACACA	jurkat
mixed_AGATCGTGAGAGTA	293t
mixed_AGATCGTGCCGTTC	293t
mixed_AGATCGTGGGGAGT	jurkat
mixed_AGATCTCTGGTATC	293t
mixed_AGATCTCTTCCAGA	jurkat
mixed_AGATTAACACCACA	jurkat
mixed_AGATTAACTAGCGT	jurkat
mixed_AGATTAACTCGTAG	jurkat
mixed_AGATTCCTAAGGTA	293t
mixed_AGATTCCTTCCAGA	jurkat
mixed_AGATTCCTTGCAGT	293t
mixed_AGCAAAGAGCGAGA	jurkat
mixed_AGCAAGCTGGACTT	jurkat
mixed_AGCAAGCTTGGATC	jurkat
mixed_AGCACAACCGAACT	293t
mixed_AGCACTGAATTTCC	jurkat
mixed_AGCACTGATGGAGG	jurkat
mixed_AGCATCGAAAAACG	293t
mixed_AGCATCGAACTCAG	293t
mixed_AGCATCGAGTTGCA	jurkat
mixed_AGCATGACCCCTAC	jurkat
mixed_AGCATGACCGGTAT	293t
mixed_AGCATGACCGTCTC	293t
mixed_AGCATGACTCGTAG	jurkat
mixed_AGCATGACTCTCCG	jurkat
mixed_AGCATTCTACTGGT	jurkat
mixed_AGCATTCTCCTCGT	293t
mixed_AGCCAATGATCTCT	jurkat
mixed_AGCCAATGTACTCT	293t
mixed_AGCCACCTACTCAG	jurkat
mixed_AGCCACCTGTATGC	293t
mixed_AGCCACCTTCTCAT	293t
mixed_AGCCGGACAGGTTC	jurkat
mixed_AGCCGGACGCGTTA	293t
mixed_AGCCGGACTCTCCG	jurkat
mixed_AGCCGGTGAAGTAG	jurkat
mixed_AGCCGGTGACCTTT	jurkat
mixed_AGCCGTCTGTTGCA	jurkat
mixed_AGCCGTCTTGCCTC	jurkat
mixed_AGCCTCACAGGAGC	293t
mixed_AGCCTCACTACTGG	293t
mixed_AGCCTCACTCCTAT	jurkat
mixed_AGCCTCTGTTACCT	293t
mixed_AGCGAACTAGAATG	jurkat
mixed_AGCGAACTCTAGTG	293t
mixed_AGCGAACTGGACGA	293t
mixed_AGCGAACTTAAGGA	293t
mixed_AGCGATACCAAAGA	293t
mixed_AGCGATACGCTTAG	293t
mixed_AGCGATACTCTCTA	293t
mixed_AGCGCCGAAACGTC	293t
mixed_AGCGCCGAAGTGTC	jurkat
mixed_AGCGCTCTCCTCGT	jurkat
mixed_AGCGGCACACTCAG	293t
mixed_AGCGGCACGGTATC	jurkat
mixed_AGCGGCTGCCAACA	jurkat
mixed_AGCGGCTGGGACGA	jurkat
mixed_AGCGGCTGTGGATC	293t
mixed_AGCGGGCTCTAGAC	293t
mixed_AGCGGGCTCTTTAC	jurkat
mixed_AGCGGGCTGGTACT	jurkat
mixed_AGCGGGCTTGTTTC	293t
mixed_AGCGTAACCTTGAG	jurkat
mixed_AGCTCGCTGTCAAC	293t
mixed_AGCTCGCTGTTTGG	293t
mixed_AGCTGCCTGACAAA	jurkat
mixed_AGCTGCCTTGACAC	293t
mixed_AGCTGCCTTTCGGA	jurkat
mixed_AGCTGCCTTTTCTG	jurkat
mixed_AGCTGTGAGAACCT	jurkat
mixed_AGCTGTGAGGAAGC	293t
mixed_AGCTTACTAGGCGA	jurkat
mixed_AGCTTTACCTCGCT	jurkat
mixed_AGCTTTACCTTCCG	jurkat
mixed_AGGAACCTCACTTT	293t
mixed_AGGAACCTCCATGA	293t
mixed_AGGAACCTGACAAA	jurkat
mixed_AGGAACCTGTTGCA	jurkat
mixed_AGGAACCTTTTGCT	jurkat
mixed_AGGAATGACTGATG	293t
mixed_AGGAATGAGTCTGA	293t
mixed_AGGACACTACCAAC	293t
mixed_AGGACACTCGTGAT	293t
mixed_AGGACACTGTCTAG	jurkat
mixed_AGGACTTGTATCTC	jurkat
mixed_AGGAGTCTAGCGTT	293t
mixed_AGGATAGAAACCGT	jurkat
mixed_AGGATAGACCGAAT	jurkat
mixed_AGGATAGACTAGTG	293t
mixed_AGGATGCTATTTCC	293t
mixed_AGGCAACTCCGAAT	jurkat
mixed_AGGCAACTGACGTT	jurkat
mixed_AGGCAACTTTCGTT	293t
mixed_AGGCAGGAAGGTCT	293t
mixed_AGGCCTCTCCCAAA	293t
mixed_AGGCCTCTGGTGTT	jurkat
mixed_AGGCTAACAGTGTC	293t
mixed_AGGCTAACCTCGAA	293t
mixed_AGGCTAACGTGTCA	jurkat
mixed_AGGGACGAAGCTAC	293t
mixed_AGGGAGTGAAGCCT	293t
mixed_AGGGAGTGCTCCAC	293t
mixed_AGGGAGTGTCGTTT	jurkat
mixed_AGGGCCACAAACAG	jurkat
mixed_AGGGCCACACGTGT	jurkat
mixed_AGGGCCTGTGTTCT	jurkat
mixed_AGGGCGCTTGATGC	jurkat
mixed_AGGGTGGAAGTTCG	jurkat
mixed_AGGGTGGACAGCTA	jurkat
mixed_AGGGTGGAGTTGGT	jurkat
mixed_AGGGTGGATCAGTG	jurkat
mixed_AGGGTGGATGATGC	jurkat
mixed_AGGGTGGATGCGTA	jurkat
mixed_AGGGTTTGCGTCTC	293t
mixed_AGGGTTTGTTCATC	293t
mixed_AGGTACACGGGATG	293t
mixed_AGGTACACTCTTTG	jurkat
mixed_AGGTACTGGCTTAG	293t
mixed_AGGTACTGTTGACG	jurkat
mixed_AGGTCATGCAGATC	293t
mixed_AGGTCATGCCGTTC	jurkat
mixed_AGGTCATGCTCTAT	jurkat
mixed_AGGTCTGAGTGCTA	jurkat
mixed_AGGTCTGATCAGGT	jurkat
mixed_AGGTGGGAACACAC	jurkat
mixed_AGGTGGGAATTGGC	293t
mixed_AGGTGGGACCCACT	jurkat
mixed_AGGTGGGACGTAGT	293t
mixed_AGGTGGGATCACCC	293t
mixed_AGGTGTTGGTTGGT	293t
mixed_AGGTGTTGTCATTC	jurkat
mixed_AGGTGTTGTCCCGT	jurkat
mixed_AGGTTCGAGCTGTA	jurkat
mixed_AGGTTGTGGGTGAG	jurkat
mixed_AGTAAGGAATGGTC	jurkat
mixed_AGTAAGGATGCTTT	jurkat
mixed_AGTAATACCCTGAA	293t
mixed_AGTAATACCGTAAC	jurkat
mixed_AGTAATACTCAGAC	jurkat
mixed_AGTAATTGAGATCC	jurkat
mixed_AGTACGTGTCTTTG	jurkat
mixed_AGTACGTGTTGGTG	293t
mixed_AGTACTCTCAAAGA	293t
mixed_AGTAGAGATTCTGT	293t
mixed_AGTAGGCTAGAATG	jurkat
mixed_AGTATAACCACACA	jurkat
mixed_AGTATAACCACTTT	293t
mixed_AGTATCCTCAAGCT	jurkat
mixed_AGTATCCTGAATCC	jurkat
mixed_AGTATCCTTGAACC	jurkat
mixed_AGTCACGAAGCATC	293t
mixed_AGTCACGAAGTGTC	293t
mixed_AGTCACGAATGACC	jurkat
mixed_AGTCACGAGGTACT	293t
mixed_AGTCACGATGTCCC	jurkat
mixed_AGTCCAGACCTAAG	293t
mixed_AGTCCAGATGTGAC	jurkat
mixed_AGTCGAACATCACG	jurkat
mixed_AGTCGCCTAGAACA	293t
mixed_AGTCGCCTAGAGTA	jurkat
mixed_AGTCGCCTTACGAC	jurkat
mixed_AGTCGCCTTTACCT	293t
mixed_AGTCTACTCAAGCT	jurkat
mixed_AGTCTACTCCGAAT	jurkat
mixed_AGTCTACTCTATTC	293t
mixed_AGTCTACTTGCTTT	293t
mixed_AGTCTTACCAGAAA	293t
mixed_AGTGACACCCTCGT	jurkat
mixed_AGTGACACTGTAGC	293t
mixed_AGTGACACTGTGGT	jurkat
mixed_AGTGCAACCGTACA	jurkat
mixed_AGTGCAACTGGAGG	jurkat
mixed_AGTGTGACAGCAAA	jurkat
mixed_AGTGTGACATCGGT	jurkat
mixed_AGTGTGACTGTCTT	293t
mixed_AGTGTTCTACCCTC	jurkat
mixed_AGTGTTCTTCCTCG	293t
mixed_AGTTAAACCATCAG	jurkat
mixed_AGTTAAACCGTACA	jurkat
mixed_AGTTAAACTGTCCC	jurkat
mixed_AGTTATGAGTCACA	293t
mixed_AGTTATGAGTCGTA	jurkat
mixed_AGTTATGAGTCTGA	293t
mixed_AGTTCTACGGGAGT	293t
mixed_AGTTCTTGTGCCCT	jurkat
mixed_AGTTGTCTAGGAGC	jurkat
mixed_AGTTGTCTCTTGTT	293t
mixed_AGTTTAGAGAACCT	293t
mixed_AGTTTAGAGCCATA	jurkat
mixed_AGTTTAGAGGTACT	jurkat
mixed_AGTTTCACCTTGAG	jurkat
mixed_AGTTTGCTTTTGTC	293t
mixed_ATAAACACAACCGT	jurkat
mixed_ATAAACACACCACA	jurkat
mixed_ATAAACACGGTTAC	jurkat
mixed_ATAAACACTATGGC	jurkat
mixed_ATAACATGAGTCTG	293t
mixed_ATAACATGCACCAA	293t
mixed_ATAACCCTGAATCC	293t
mixed_ATAACCCTTAGCCA	jurkat
mixed_ATAAGTACTGTCTT	jurkat
mixed_ATAAGTTGCGTTGA	jurkat
mixed_ATAAGTTGCTAGAC	293t
mixed_ATAAGTTGGCTATG	jurkat
mixed_ATAAGTTGTCACCC	jurkat
mixed_ATAATCGAACAGCT	293t
mixed_ATAATCGAGGCATT	jurkat
mixed_ATAATCGAGTAAAG	jurkat
mixed_ATAATCGAGTAGGG	293t
mixed_ATAATGACCCGTTC	293t
mixed_ATAATGACTGCAAC	jurkat
mixed_ATACAATGGGCAAG	293t
mixed_ATACAATGTCTTAC	jurkat
mixed_ATACACCTTCCTGC	293t
mixed_ATACCGGAGATGAA	jurkat
mixed_ATACCTACTGATGC	jurkat
mixed_ATACCTTGTGCCAA	293t
mixed_ATACGGACAAGCAA	jurkat
mixed_ATACGGACCTTGGA	jurkat
mixed_ATACGGACTTTGGG	jurkat
mixed_ATACTCTGGAACCT	jurkat
mixed_ATACTCTGGCCTTC	293t
mixed_ATACTCTGTCCAGA	jurkat
mixed_ATACTCTGTCCTTA	293t
mixed_ATAGAACTACCACA	jurkat
mixed_ATAGAACTCAGAGG	293t
mixed_ATAGAACTTTGTGG	293t
mixed_ATAGAACTTTTCAC	293t
mixed_ATAGATACCTGAGT	293t
mixed_ATAGATTGATCACG	jurkat
mixed_ATAGCCGAATGACC	jurkat
mixed_ATAGCGTGACACTG	293t
mixed_ATAGCGTGAGTCTG	jurkat
mixed_ATAGCGTGGGGATG	293t
mixed_ATAGCTCTAGATCC	293t
mixed_ATAGCTCTCCGTAA	jurkat
mixed_ATAGCTCTCGCTAA	jurkat
mixed_ATAGCTCTTCGCCT	293t
mixed_ATAGGAGATGCGTA	jurkat
mixed_ATAGGCTGCTGGTA	293t
mixed_ATAGTCCTCTGCAA	293t
mixed_ATAGTTGACAAAGA	293t
mixed_ATAGTTGACTTCTA	jurkat
mixed_ATAGTTGATCATTC	jurkat
mixed_ATAGTTGATCTCAT	293t
mixed_ATAGTTGATGCCTC	293t
mixed_ATATACGAGAACCT	jurkat
mixed_ATATACGAGTAGCT	293t
mixed_ATATACGAGTTCAG	293t
mixed_ATATACGATGAGGG	293t
mixed_ATATAGTGAGTACC	293t
mixed_ATATAGTGCGTTAG	jurkat
mixed_ATATAGTGTTTCGT	293t
mixed_ATATGAACGTGTCA	jurkat
mixed_ATATGAACTGGATC	293t
mixed_ATATGCCTCACACA	293t
mixed_ATATGCCTTCATTC	jurkat
mixed_ATATGCCTTCCGTC	293t
mixed_ATCAAATGTCAAGC	jurkat
mixed_ATCAACCTAACCGT	293t
mixed_ATCAACCTACCCTC	293t
mixed_ATCAACCTCCAACA	jurkat
mixed_ATCAACCTCCGCTT	293t
mixed_ATCAACCTGGTTAC	293t
mixed_ATCACACTCTATGG	293t
mixed_ATCACGGACTCTCG	293t
mixed_ATCACGGAGGTGAG	293t
mixed_ATCACGGATGAACC	293t
mixed_ATCACTACAGGAGC	jurkat
mixed_ATCACTACATCGAC	293t
mixed_ATCACTACCAGTTG	293t
mixed_ATCACTTGGCGATT	293t
mixed_ATCACTTGTATCTC	293t
mixed_ATCAGGTGGAAAGT	293t
mixed_ATCAGGTGGTACCA	293t
mixed_ATCATCTGAAGAGT	jurkat
mixed_ATCATCTGACCTGA	jurkat
mixed_ATCATCTGAGAAGT	293t
mixed_ATCATCTGCCGAAT	jurkat
mixed_ATCATCTGGAATAG	jurkat
mixed_ATCATCTGTGCTAG	jurkat
mixed_ATCATCTGTTCGGA	jurkat
mixed_ATCATGCTAAACAG	293t
mixed_ATCATGCTGCTTCC	293t
mixed_ATCCATACTAGTCG	jurkat
mixed_ATCCCGTGGTCCTC	jurkat
mixed_ATCCCGTGTTGGCA	293t
mixed_ATCCTAACAGGTTC	293t
mixed_ATCGACGAGAACCT	jurkat
mixed_ATCGACGAGAGGAC	jurkat
mixed_ATCGAGTGCTACTT	293t
mixed_ATCGCAGATCGCAA	jurkat
mixed_ATCGCCACAAGAGT	293t
mixed_ATCGCCACCCGCTT	293t
mixed_ATCGCCACTAGCGT	293t
mixed_ATCGCGCTACCGAT	jurkat
mixed_ATCGCGCTCATTTC	293t
mixed_ATCGCGCTGCTGAT	293t
mixed_ATCGGAACATGTCG	jurkat
mixed_ATCGGAACGCCCTT	293t
mixed_ATCGGTGAAAGTAG	jurkat
mixed_ATCGGTGAGGTTAC	293t
mixed_ATCGGTGATCAAGC	jurkat
mixed_ATCGTTTGGGCAAG	jurkat
mixed_ATCTACACGCGATT	jurkat
mixed_ATCTACACTCCCAC	293t
mixed_ATCTACTGATCGTG	293t
mixed_ATCTGACTAAGCAA	293t
mixed_ATCTGACTGGAGCA	jurkat
mixed_ATCTGACTTAGAGA	293t
mixed_ATCTGACTTGCAGT	293t
mixed_ATCTGGGAACCCTC	jurkat
mixed_ATCTGGGACTTCTA	jurkat
mixed_ATCTGTTGAAGCAA	jurkat
mixed_ATCTGTTGCGACAT	293t
mixed_ATCTGTTGGCTTCC	293t
mixed_ATCTTGACAGTCGT	jurkat
mixed_ATCTTGACGTTTGG	jurkat
mixed_ATCTTGACTGACAC	jurkat
mixed_ATCTTTCTAAGTGA	jurkat
mixed_ATCTTTCTTGAGGG	293t
mixed_ATCTTTCTTGCAGT	293t
mixed_ATGAAACTCCATGA	jurkat
mixed_ATGAAACTCGGAGA	293t
mixed_ATGAAGGAACTACG	jurkat
mixed_ATGAAGGAGTTCTT	jurkat
mixed_ATGACGTGAAGGTA	jurkat
mixed_ATGACGTGTCAGTG	jurkat
mixed_ATGAGAGAGACGTT	jurkat
mixed_ATGAGAGAGCGTTA	jurkat
mixed_ATGAGCACAGATGA	jurkat
mixed_ATGAGCACCCCACT	293t
mixed_ATGAGCACCCGAAT	jurkat
mixed_ATGAGCACTCGTAG	jurkat
mixed_ATGATAACCGGAGA	293t
mixed_ATGATAACTGACCA	jurkat
mixed_ATGATATGGGAAAT	jurkat
mixed_ATGATATGTACTGG	jurkat
mixed_ATGCACGAGTGCAT	293t
mixed_ATGCAGTGGGACTT	jurkat
mixed_ATGCAGTGTTTGTC	jurkat
mixed_ATGCCAGAAGAGAT	jurkat
mixed_ATGCCAGAAGGTTC	jurkat
mixed_ATGCCAGACGTAAC	293t
mixed_ATGCCAGATACTGG	293t
mixed_ATGCCGCTCCCAAA	jurkat
mixed_ATGCCGCTCCGTTC	jurkat
mixed_ATGCCGCTTACGAC	jurkat
mixed_ATGCCGCTTATGGC	jurkat
mixed_ATGCGATGATCAGC	jurkat
mixed_ATGCGATGCCTTAT	293t
mixed_ATGCGATGTATGGC	293t
mixed_ATGCGATGTCTGGA	293t
mixed_ATGCGCCTGTTGAC	293t
mixed_ATGCTTTGACGGAG	jurkat
mixed_ATGCTTTGTCCTTA	293t
mixed_ATGGGTACGAGCTT	293t
mixed_ATGGGTACGTTGAC	jurkat
mixed_ATGGTGACACCATG	293t
mixed_ATGGTGACGAATAG	jurkat
mixed_ATGTAAACCGAGAG	jurkat
mixed_ATGTAAACTTTACC	jurkat
mixed_ATGTACCTCTATTC	jurkat
mixed_ATGTACCTGCTTAG	jurkat
mixed_ATGTCACTCACTAG	293t
mixed_ATGTCGGAACACCA	jurkat
mixed_ATGTCGGAAGAATG	293t
mixed_ATGTCGGACTGTGA	jurkat
mixed_ATGTCGGATAGAGA	293t
mixed_ATGTCGGATGACTG	293t
mixed_ATGTTAGACCTCGT	293t
mixed_ATGTTAGACTCGAA	293t
mixed_ATGTTAGAGTGTAC	jurkat
mixed_ATGTTCACAACCTG	293t
mixed_ATGTTCACCTCAGA	jurkat
mixed_ATGTTCACGTGTCA	jurkat
mixed_ATGTTGCTATCACG	293t
mixed_ATGTTGCTCTCATT	293t
mixed_ATTAACGAATGTCG	jurkat
mixed_ATTAACGACAACCA	293t
mixed_ATTAACGAGAGCTT	jurkat
mixed_ATTAAGACCTACGA	jurkat
mixed_ATTAAGACGAGATA	jurkat
mixed_ATTAAGACTGAGGG	293t
mixed_ATTAAGACTTGGTG	jurkat
mixed_ATTACCACAAAACG	jurkat
mixed_ATTACCACACCGAT	293t
mixed_ATTACCACGCTCCT	293t
mixed_ATTACCTGACCCAA	293t
mixed_ATTACCTGCTCATT	293t
mixed_ATTACCTGCTGTTT	jurkat
mixed_ATTACCTGGTTCTT	293t
mixed_ATTACCTGTAACCG	293t
mixed_ATTAGATGACCAAC	293t
mixed_ATTAGATGCTACCC	jurkat
mixed_ATTAGATGTGAGAA	293t
mixed_ATTAGTGACATGAC	293t
mixed_ATTAGTGACATTGG	jurkat
mixed_ATTATGGACACTCC	jurkat
mixed_ATTATGGATTCTTG	jurkat
mixed_ATTCAAGAAAAGTG	jurkat
mixed_ATTCAAGACATTGG	293t
mixed_ATTCAAGATACGCA	293t
mixed_ATTCAAGATGCTAG	293t
mixed_ATTCAAGATGTGCA	jurkat
mixed_ATTCAAGATTCGCC	293t
mixed_ATTCAGCTACCCTC	293t
mixed_ATTCAGCTCTCTTA	jurkat
mixed_ATTCCAACAAGAAC	293t
mixed_ATTCCAACGCATAC	jurkat
mixed_ATTCCAACGTATCG	jurkat
mixed_ATTCCAACTGGTTG	jurkat
mixed_ATTCCATGAAGCCT	jurkat
mixed_ATTCCATGCACTAG	jurkat
mixed_ATTCGACTTCCGAA	293t
mixed_ATTCGACTTCTCGC	jurkat
mixed_ATTCGGGAACGGGA	jurkat
mixed_ATTCGGGACGGTAT	293t
mixed_ATTCGGGATCATTC	jurkat
mixed_ATTCGGGATGTGGT	293t
mixed_ATTCTGACAGAGGC	jurkat
mixed_ATTCTGACTGGCAT	jurkat
mixed_ATTCTTCTAGCTAC	jurkat
mixed_ATTCTTCTAGGGTG	293t
mixed_ATTCTTCTCTCCCA	jurkat
mixed_ATTCTTCTCTCTTA	jurkat
mixed_ATTCTTCTGATAGA	293t
mixed_ATTCTTCTTCCAAG	293t
mixed_ATTGAAACAACCGT	jurkat
mixed_ATTGAAACACGTAC	jurkat
mixed_ATTGAATGGCTAAC	293t
mixed_ATTGAATGGGGCAA	293t
mixed_ATTGAATGTGCAAC	jurkat
mixed_ATTGAATGTTCCGC	jurkat
mixed_ATTGATGAAAGAGT	jurkat
mixed_ATTGATGACAGTTG	293t
mixed_ATTGATGACGAGAG	jurkat
mixed_ATTGATGAGGTAAA	293t
mixed_ATTGCACTACACGT	293t
mixed_ATTGCACTAGTCGT	jurkat
mixed_ATTGCGGAAAAGTG	293t
mixed_ATTGCGGACTTAGG	jurkat
mixed_ATTGCGGAGTCTGA	jurkat
mixed_ATTGCGGATAGAAG	jurkat
mixed_ATTGCGGATTTCGT	jurkat
mixed_ATTGCTACATGCCA	293t
mixed_ATTGCTACCAGTCA	293t
mixed_ATTGCTACCTTGGA	293t
mixed_ATTGCTACGCTGTA	jurkat
mixed_ATTGCTACGTTCGA	293t
mixed_ATTGCTACTGACCA	jurkat
mixed_ATTGCTTGTTCACT	293t
mixed_ATTGGGTGCTAGTG	jurkat
mixed_ATTGGGTGGAAACA	jurkat
mixed_ATTGGGTGTTTGTC	293t
mixed_ATTGGTCTCTCGCT	jurkat
mixed_ATTGTAGAGCTCCT	jurkat
mixed_ATTGTAGAGGAGTG	jurkat
mixed_ATTGTCTGCGATAC	jurkat
mixed_ATTGTCTGCTGGTA	jurkat
mixed_ATTGTCTGTGAAGA	jurkat
mixed_ATTTAGGAACAGTC	jurkat
mixed_ATTTAGGAATGCCA	293t
mixed_ATTTAGGAGTAGGG	293t
mixed_ATTTCCGACAGTCA	jurkat
mixed_ATTTCCGACTACCC	jurkat
mixed_ATTTCCGACTACTT	293t
mixed_ATTTCCGATGCTCC	293t
mixed_ATTTCGTGTGTGAC	jurkat
mixed_ATTTCTCTCAACCA	jurkat
mixed_ATTTCTCTCACTAG	jurkat
mixed_ATTTGCACCAAAGA	293t
mixed_ATTTGCACGCGAGA	jurkat
mixed_ATTTGCACTTGGCA	jurkat
mixed_CAAACTCTGTGCTA	293t
mixed_CAAAGCACATTTCC	jurkat
mixed_CAAAGCACCTTCTA	jurkat
mixed_CAAAGCACTCTGGA	293t
mixed_CAAAGCTGATCGGT	293t
mixed_CAAAGCTGCACTTT	293t
mixed_CAAAGCTGTACTTC	jurkat
mixed_CAAATATGAACCAC	293t
mixed_CAAATATGTGGGAG	jurkat
mixed_CAAATTGATCTCTA	293t
mixed_CAACAGACGAGCTT	jurkat
mixed_CAACCAGAGTCCTC	jurkat
mixed_CAACCGCTAGAGAT	jurkat
mixed_CAACCGCTCTGTTT	293t
mixed_CAACCGCTGGGACA	jurkat
mixed_CAACGAACCTGAAC	293t
mixed_CAACGATGAACCTG	jurkat
mixed_CAACGATGCGTGTA	293t
mixed_CAACGTGAACCCTC	293t
mixed_CAACGTGACCGTTC	293t
mixed_CAACGTGACTACCC	293t
mixed_CAACGTGAGAAAGT	jurkat
mixed_CAACGTGAGTTCAG	jurkat
mixed_CAACTTTGGGCATT	jurkat
mixed_CAAGAAGACCAGTA	jurkat
mixed_CAAGACACACTAGC	jurkat
mixed_CAAGACACCACTCC	293t
mixed_CAAGACACTCGCCT	jurkat
mixed_CAAGACACTTTGGG	293t
mixed_CAAGACTGCAAAGA	jurkat
mixed_CAAGACTGCTGTTT	293t
mixed_CAAGACTGCTTCGC	293t
mixed_CAAGACTGGACACT	jurkat
mixed_CAAGCATGAGCTAC	293t
mixed_CAAGCATGCAGATC	293t
mixed_CAAGCATGGACGAG	jurkat
mixed_CAAGCCCTAGCACT	293t
mixed_CAAGCTGACAGTTG	293t
mixed_CAAGCTGACGGGAA	jurkat
mixed_CAAGCTGATCTTAC	jurkat
mixed_CAAGGACTAGGGTG	jurkat
mixed_CAAGGACTTACTCT	293t
mixed_CAAGGTTGTCCCAC	293t
mixed_CAAGGTTGTGTGCA	293t
mixed_CAAGTCGAGCTGAT	293t
mixed_CAAGTCGATCGTAG	jurkat
mixed_CAAGTCGATCTACT	293t
mixed_CAAGTCGATTGGTG	293t
mixed_CAATAAACCATTTC	293t
mixed_CAATAAACGTTCAG	293t
mixed_CAATAAACTACTCT	jurkat
mixed_CAATAATGTCCTCG	jurkat
mixed_CAATAATGTGAGAA	293t
mixed_CAATCGGACTTCTA	293t
mixed_CAATCTACAAGAGT	jurkat
mixed_CAATCTACAGCTAC	jurkat
mixed_CAATCTACCGATAC	293t
mixed_CAATTCACAAAAGC	jurkat
mixed_CAATTCACGACAGG	jurkat
mixed_CAATTCACTATTCC	293t
mixed_CACAACGAAACCTG	jurkat
mixed_CACAACGACCAGTA	jurkat
mixed_CACAACGACGACAT	293t
mixed_CACAATCTCAACTG	jurkat
mixed_CACAATCTGAAAGT	jurkat
mixed_CACAATCTTTCGTT	jurkat
mixed_CACACCTGGCTAAC	293t
mixed_CACACCTGTCTACT	jurkat
mixed_CACAGAACGACGAG	293t
mixed_CACAGCCTACTTTC	293t
mixed_CACAGTGACCTCCA	jurkat
mixed_CACAGTGAGAATGA	jurkat
mixed_CACAGTGAGTCTGA	jurkat
mixed_CACATACTCGGAGA	jurkat
mixed_CACATACTCTGCAA	293t
mixed_CACATACTTCGACA	jurkat
mixed_CACATACTTGACTG	jurkat
mixed_CACATGGAGGTCTA	jurkat
mixed_CACATGGAGTGCTA	jurkat
mixed_CACCACTGCACAAC	jurkat
mixed_CACCACTGCGTACA	293t
mixed_CACCCATGGTACCA	jurkat
mixed_CACCCATGTCTTCA	293t
mixed_CACCGTACATTCCT	293t
mixed_CACCGTACCTCAAG	jurkat
mixed_CACCGTACGTGAGG	jurkat
mixed_CACCGTTGAGCACT	293t
mixed_CACCGTTGTAGAGA	293t
mixed_CACCGTTGTGAGGG	293t
mixed_CACCGTTGTTACTC	jurkat
mixed_CACCTGACACGGTT	293t
mixed_CACCTGACAGATGA	293t
mixed_CACCTGACCATTCT	jurkat
mixed_CACCTGACGAACTC	293t
mixed_CACCTGACTGATGC	jurkat
mixed_CACGAAACACCCTC	jurkat
mixed_CACGACCTACCATG	jurkat
mixed_CACGATGACGAGTT	293t
mixed_CACGGGACGAGGTG	jurkat
mixed_CACGGGACGTTGTG	jurkat
mixed_CACGGGACTGCTGA	jurkat
mixed_CACGGGACTTCCAT	jurkat
mixed_CACGGGTGTTATCC	293t
mixed_CACTAACTAGGTCT	293t
mixed_CACTAACTGACGTT	jurkat
mixed_CACTAACTTGTGGT	jurkat
mixed_CACTAACTTTGACG	jurkat
mixed_CACTAGGAAATGCC	jurkat
mixed_CACTAGGAAGTGTC	293t
mixed_CACTAGGAGCCTTC	jurkat
mixed_CACTCTCTGTTGAC	jurkat
mixed_CACTCTCTTGTAGC	jurkat
mixed_CACTGAGACGAGTT	293t
mixed_CACTGAGATATGGC	293t
mixed_CACTGAGATCTAGG	jurkat
mixed_CACTGCACTAACCG	jurkat
mixed_CACTGCACTTCCAT	293t
mixed_CACTGCTGGATAAG	293t
mixed_CACTGCTGGGAGTG	jurkat
mixed_CACTGCTGGTACCA	jurkat
mixed_CACTGCTGTCGCAA	293t
mixed_CACTTAACCTGAGT	jurkat
mixed_CACTTAACGCCTTC	jurkat
mixed_CACTTATGACTTTC	293t
mixed_CACTTATGTGCGTA	jurkat
mixed_CAGAAGCTACTCAG	293t
mixed_CAGAAGCTCTCAGA	jurkat
mixed_CAGAAGCTGCAGTT	jurkat
mixed_CAGAAGCTTGTGAC	293t
mixed_CAGACAACAACCAC	jurkat
mixed_CAGACAACACTCTT	jurkat
mixed_CAGACAACGCATAC	jurkat
mixed_CAGACATGGGATTC	jurkat
mixed_CAGACATGTGGTCA	293t
mixed_CAGACCCTCCATGA	jurkat
mixed_CAGACCCTCGACTA	jurkat
mixed_CAGACTGACGAACT	jurkat
mixed_CAGACTGAGGACTT	293t
mixed_CAGACTGATGAGGG	293t
mixed_CAGACTGATTCACT	293t
mixed_CAGAGGGACTTATC	293t
mixed_CAGATCGAAGAACA	jurkat
mixed_CAGATCGATTTGGG	293t
mixed_CAGATGACACCGAT	jurkat
mixed_CAGATGACCTTGCC	jurkat
mixed_CAGCAATGGACTAC	293t
mixed_CAGCAATGTTAGGC	jurkat
mixed_CAGCAATGTTGACG	jurkat
mixed_CAGCACCTACCAAC	293t
mixed_CAGCACCTACTTTC	jurkat
mixed_CAGCACCTGTTTGG	jurkat
mixed_CAGCACCTTCTCGC	293t
mixed_CAGCATGAACCACA	293t
mixed_CAGCATGAACTCAG	jurkat
mixed_CAGCATGAAGAACA	jurkat
mixed_CAGCATGAGACGGA	293t
mixed_CAGCATGATACAGC	jurkat
mixed_CAGCCTACAAACAG	293t
mixed_CAGCCTACTAGTCG	293t
mixed_CAGCCTTGCTACTT	293t
mixed_CAGCCTTGGGTCTA	293t
mixed_CAGCGGACGAACCT	jurkat
mixed_CAGCGGACGCGGAA	jurkat
mixed_CAGCTAGACAGCTA	293t
mixed_CAGCTAGACTGAAC	293t
mixed_CAGCTCACAAAACG	jurkat
mixed_CAGCTCACGCCCTT	jurkat
mixed_CAGCTCACGTGTTG	jurkat
mixed_CAGCTCACGTTCTT	293t
mixed_CAGCTCACTGCATG	jurkat
mixed_CAGCTCACTGTCAG	jurkat
mixed_CAGCTCTGGCCATA	293t
mixed_CAGCTCTGGGCATT	293t
mixed_CAGCTCTGGGTTAC	jurkat
mixed_CAGCTCTGTTGAGC	jurkat
mixed_CAGGAACTCCGCTT	jurkat
mixed_CAGGGCACGACGAG	293t
mixed_CAGGGCACTGGTTG	293t
mixed_CAGGTATGAAACGA	293t
mixed_CAGGTATGGCCTTC	jurkat
mixed_CAGGTATGGTGCTA	jurkat
mixed_CAGGTATGGTTAGC	293t
mixed_CAGGTATGTTGCAG	jurkat
mixed_CAGGTTGAACACGT	293t
mixed_CAGGTTGACCTCAC	jurkat
mixed_CAGGTTGAGTTTCT	jurkat
mixed_CAGTCAGAATGTGC	jurkat
mixed_CAGTCAGACATACG	jurkat
mixed_CAGTCAGATCATTC	293t
mixed_CAGTGATGACACTG	jurkat
mixed_CAGTGATGCGAGAG	jurkat
mixed_CAGTGATGCGATAC	293t
mixed_CAGTGATGGTTACG	293t
mixed_CAGTGATGTCTTTG	jurkat
mixed_CAGTGATGTGTTTC	jurkat
mixed_CAGTGTGATGACTG	jurkat
mixed_CAGTGTGATGGTGT	jurkat
mixed_CAGTTACTCTAAGC	jurkat
mixed_CAGTTACTGCATCA	293t
mixed_CAGTTGGATACGCA	jurkat
mixed_CAGTTTACCCCAAA	293t
mixed_CAGTTTACGGAGCA	293t
mixed_CAGTTTACGGGCAA	jurkat
mixed_CATAAAACCAGATC	293t
mixed_CATAAATGGCAGAG	293t
mixed_CATAAATGTCGCAA	jurkat
mixed_CATAACCTAATCGC	jurkat
mixed_CATAACCTAGTGTC	293t
mixed_CATAACCTTCTATC	293t
mixed_CATAACCTTGACAC	jurkat
mixed_CATAGTCTAGCTAC	293t
mixed_CATAGTCTCCATGA	jurkat
mixed_CATATAGATGTTTC	293t
mixed_CATCAACTCCCTTG	293t
mixed_CATCAACTTCCCAC	293t
mixed_CATCAGGAACGGAG	jurkat
mixed_CATCAGGACAGTTG	jurkat
mixed_CATCAGGATCGTTT	293t
mixed_CATCAGGATTCTTG	293t
mixed_CATCATACTTGCAG	jurkat
mixed_CATCCCGAAACGAA	jurkat
mixed_CATCCCGAGTTACG	293t
mixed_CATCCCGATAACGC	jurkat
mixed_CATCCCGATGTGAC	293t
mixed_CATCGGCTACCACA	293t
mixed_CATCGGCTAGAACA	jurkat
mixed_CATCGGCTGAACCT	293t
mixed_CATCGGCTTCAAGC	293t
mixed_CATCTCCTGGTAAA	293t
mixed_CATCTCCTTCTACT	293t
mixed_CATCTTGAGTACCA	jurkat
mixed_CATCTTGATCACGA	293t
mixed_CATCTTGATCGTAG	293t
mixed_CATGAGACAGACTC	jurkat
mixed_CATGAGACGGTGAG	293t
mixed_CATGAGACTATCTC	293t
mixed_CATGCCACGGAACG	293t
mixed_CATGCCACTTCCGC	293t
mixed_CATGCGCTAGAGTA	293t
mixed_CATGCGCTCCCTCA	jurkat
mixed_CATGCGCTGTTACG	293t
mixed_CATGGATGCCCAAA	jurkat
mixed_CATGGATGTGCGTA	293t
mixed_CATGGCCTCTTCCG	jurkat
mixed_CATGGCCTGGTCAT	jurkat
mixed_CATGGCCTGGTTTG	jurkat
mixed_CATGGCCTTTACTC	jurkat
mixed_CATGTACTTCGACA	jurkat
mixed_CATGTTACCCGCTT	293t
mixed_CATGTTACGGACTT	293t
mixed_CATGTTTGACGTAC	jurkat
mixed_CATGTTTGTTACCT	293t
mixed_CATTACACAGTACC	293t
mixed_CATTACACGACACT	293t
mixed_CATTACACGGTTAC	jurkat
mixed_CATTACACTAACCG	293t
mixed_CATTAGCTAGAGTA	jurkat
mixed_CATTAGCTGTGTTG	jurkat
mixed_CATTGACTAGCCTA	293t
mixed_CATTGGGACTGCTC	jurkat
mixed_CATTGTACATGTCG	jurkat
mixed_CATTGTACCATGGT	jurkat
mixed_CATTGTACGCCCTT	jurkat
mixed_CATTGTACGGGCAA	293t
mixed_CATTGTACTGGAGG	jurkat
mixed_CATTGTACTTCTAC	293t
mixed_CATTGTTGAGGAGC	jurkat
mixed_CATTGTTGGTAAAG	293t
mixed_CATTTCGAAGCTAC	jurkat
mixed_CATTTGACGGTTTG	jurkat
mixed_CATTTGTGAGTCAC	293t
mixed_CATTTGTGCATGCA	jurkat
mixed_CATTTGTGCTAGCA	293t
mixed_CATTTGTGGTCGTA	jurkat
mixed_CCAAAGTGATTTCC	293t
mixed_CCAAAGTGTCCTAT	293t
mixed_CCAACCTGCACACA	293t
mixed_CCAACCTGGGGAGT	jurkat
mixed_CCAACCTGTAGCGT	jurkat
mixed_CCAACCTGTCTAGG	293t
mixed_CCAAGAACTGTCTT	293t
mixed_CCAAGATGTGTCGA	jurkat
mixed_CCAAGTGATCGCTC	jurkat
mixed_CCAAGTGATTGCTT	293t
mixed_CCAATGGACTTCTA	jurkat
mixed_CCAATGGAGGTAAA	jurkat
mixed_CCAATTTGCGGAGA	293t
mixed_CCAATTTGCTGAAC	293t
mixed_CCACCATGCATACG	jurkat
mixed_CCACCATGGACACT	jurkat
mixed_CCACCATGTCCAGA	293t
mixed_CCACCATGTGCGTA	jurkat
mixed_CCACCTGAGCGAGA	jurkat
mixed_CCACGGGAGGAAGC	293t
mixed_CCACTGACCCCGTT	293t
mixed_CCACTGACGGACTT	jurkat
mixed_CCACTGTGCGAGTT	jurkat
mixed_CCACTTCTTCCTGC	293t
mixed_CCAGAAACCCCTTG	jurkat
mixed_CCAGAAACTGGTGT	jurkat
mixed_CCAGAAACTGTAGC	293t
mixed_CCAGACCTTACAGC	jurkat
mixed_CCAGCACTACCCTC	293t
mixed_CCAGCACTCATGCA	jurkat
mixed_CCAGCTACTACAGC	jurkat
mixed_CCAGGTCTAGCATC	293t
mixed_CCAGGTCTGCTATG	293t
mixed_CCAGTCACAGTCTG	jurkat
mixed_CCAGTCACCCCAAA	293t
mixed_CCAGTCACTACTGG	jurkat
mixed_CCAGTCTGGTTCGA	jurkat
mixed_CCAGTCTGTTCCCG	293t
mixed_CCAGTGCTCTTGTT	jurkat
mixed_CCAGTGCTGAGCAG	293t
mixed_CCAGTGCTTCACCC	jurkat
mixed_CCATAGGACGTAAC	293t
mixed_CCATAGGATCGACA	293t
mixed_CCATATACATGTGC	293t
mixed_CCATCCGATGCAGT	293t
mixed_CCATCCGATGGGAG	jurkat
mixed_CCATCGTGCGGAGA	293t
mixed_CCATGCTGCTTGCC	293t
mixed_CCATTAACTTACTC	293t
mixed_CCCAAAGACCCACT	293t
mixed_CCCAACACACCTGA	293t
mixed_CCCAACACCTACTT	jurkat
mixed_CCCAACTGCACAAC	jurkat
mixed_CCCAACTGGATGAA	jurkat
mixed_CCCAACTGGTTAGC	293t
mixed_CCCAGACTGAACTC	jurkat
mixed_CCCAGACTGCCATA	jurkat
mixed_CCCAGTTGAAAAGC	293t
mixed_CCCAGTTGTTCAGG	jurkat
mixed_CCCATCGACCAATG	293t
mixed_CCCATCGACTACGA	jurkat
mixed_CCCATCGAGGGAGT	293t
mixed_CCCATCGATGTTCT	293t
mixed_CCCATGTGCGAGTT	jurkat
mixed_CCCATGTGCTACTT	293t
mixed_CCCATGTGCTCGCT	293t
mixed_CCCATGTGGACGTT	jurkat
mixed_CCCATGTGTCTTTG	293t
mixed_CCCATGTGTTCTAC	293t
mixed_CCCGAACTGGAACG	293t
mixed_CCCGAACTGTTTCT	jurkat
mixed_CCCGAACTTTGCAG	293t
mixed_CCCGATTGCTCGCT	293t
mixed_CCCGATTGGTATGC	jurkat
mixed_CCCGGAGAACGACT	jurkat
mixed_CCCGGAGACGTAGT	jurkat
mixed_CCCGGAGACTTCTA	jurkat
mixed_CCCGGAGATGTCCC	jurkat
mixed_CCCTACGATGATGC	jurkat
mixed_CCCTAGTGACCTAG	jurkat
mixed_CCCTAGTGATGCTG	jurkat
mixed_CCCTAGTGGATACC	293t
mixed_CCCTCAGAAACCAC	293t
mixed_CCCTCAGAAAGCCT	jurkat
mixed_CCCTCAGAAAGGGC	293t
mixed_CCCTCAGACATGGT	293t
mixed_CCCTCAGAGTTGGT	293t
mixed_CCCTGAACATAAGG	293t
mixed_CCCTGATGAAGGGC	jurkat
mixed_CCCTGATGACACGT	293t
mixed_CCCTGATGGTTTCT	293t
mixed_CCGAAAACCCCGTT	jurkat
mixed_CCGAAAACTTACTC	jurkat
mixed_CCGACACTGCGTAT	jurkat
mixed_CCGACTACGTCATG	293t
mixed_CCGATAGAAACCTG	293t
mixed_CCGATAGACATTCT	293t
mixed_CCGATAGACTTGCC	jurkat
mixed_CCGATAGATCGCCT	jurkat
mixed_CCGCGAGAAACGAA	jurkat
mixed_CCGCGAGATTCCCG	293t
mixed_CCGCTATGACGGTT	jurkat
mixed_CCGCTATGCCACAA	jurkat
mixed_CCGCTATGGTTAGC	293t
mixed_CCGCTATGTACTGG	jurkat
mixed_CCGGAGTGCAGAAA	293t
mixed_CCGGAGTGCTAGCA	293t
mixed_CCGGAGTGGAGGAC	293t
mixed_CCGGAGTGGGACTT	jurkat
mixed_CCGGAGTGTGAAGA	jurkat
mixed_CCGGAGTGTTTACC	jurkat
mixed_CCGGTACTAGCAAA	jurkat
mixed_CCGTAAGACCCTAC	jurkat
mixed_CCGTAAGAGTGAGG	293t
mixed_CCGTACACCGTCTC	293t
mixed_CCGTACACTTATCC	293t
mixed_CCTAAACTGAGATA	jurkat
mixed_CCTAAGGACGATAC	jurkat
mixed_CCTAAGGAGAACTC	jurkat
mixed_CCTAAGGAGTAAGA	jurkat
mixed_CCTACCGACATGCA	jurkat
mixed_CCTATAACGCTAAC	jurkat
mixed_CCTATTGACACACA	293t
mixed_CCTATTGAGCATCA	jurkat
mixed_CCTCATCTCACTTT	jurkat
mixed_CCTCATCTCTTGCC	jurkat
mixed_CCTCATCTTCGATG	293t
mixed_CCTCGAACAGAAGT	293t
mixed_CCTCGAACGAGGAC	293t
mixed_CCTCGAACTAAGGA	jurkat
mixed_CCTCTACTCGATAC	293t
mixed_CCTCTACTGTTTGG	293t
mixed_CCTGACTGCCCTTG	jurkat
mixed_CCTGAGCTAGTCAC	293t
mixed_CCTGAGCTGGAGTG	293t
mixed_CCTGAGCTTCCAGA	jurkat
mixed_CCTGCAACCTACTT	293t
mixed_CCTGGACTAGGTTC	jurkat
mixed_CCTGGACTGTTCAG	jurkat
mixed_CCTGGACTTACAGC	293t
mixed_CCTTAATGCTCAGA	293t
mixed_CCTTAATGGCTATG	jurkat
mixed_CCTTAATGGTAAAG	jurkat
mixed_CCTTAATGTGACAC	jurkat
mixed_CCTTCACTATTCGG	jurkat
mixed_CCTTCACTCAGGAG	293t
mixed_CCTTCACTTTTACC	jurkat
mixed_CCTTTAGAAAGGTA	293t
mixed_CGAACATGACGCAT	293t
mixed_CGAACATGCCTTTA	293t
mixed_CGAACATGGACAGG	293t
mixed_CGAACATGGGTAGG	293t
mixed_CGAACATGTTCTCA	293t
mixed_CGAAGACTCAAGCT	293t
mixed_CGAAGACTCTGAAC	jurkat
mixed_CGAAGACTGACGAG	jurkat
mixed_CGAAGACTGTTGTG	jurkat
mixed_CGAAGACTTACTCT	jurkat
mixed_CGAAGACTTCGCTC	293t
mixed_CGAAGGGAAGTAGA	jurkat
mixed_CGAAGGGAATCTTC	jurkat
mixed_CGAAGGGAGGATCT	293t
mixed_CGAAGGGATAGCCA	293t
mixed_CGAAGTACCGTACA	jurkat
mixed_CGAATCGAAAGAAC	jurkat
mixed_CGAATCGACCCTCA	jurkat
mixed_CGAATCGAGCTATG	293t
mixed_CGAATCGATGTGCA	293t
mixed_CGACAAACCATACG	jurkat
mixed_CGACCACTGGTACT	293t
mixed_CGACCGGACCGCTT	293t
mixed_CGACCTACAAAAGC	293t
mixed_CGACCTACTGCAGT	293t
mixed_CGACCTTGATTCTC	jurkat
mixed_CGACCTTGGAAGGC	293t
mixed_CGACGTCTTCAAGC	jurkat
mixed_CGACGTCTTCACCC	jurkat
mixed_CGACTCACCCTATT	jurkat
mixed_CGACTCACGAGGCA	293t
mixed_CGACTCACGGTTTG	293t
mixed_CGACTGCTAGGAGC	293t
mixed_CGACTGCTAGTGTC	293t
mixed_CGACTGCTGTAGGG	293t
mixed_CGACTGCTTGAGGG	jurkat
mixed_CGAGAACTGACGGA	293t
mixed_CGAGAACTTATTCC	jurkat
mixed_CGAGAACTTGCGTA	293t
mixed_CGAGAACTTTTACC	293t
mixed_CGAGATTGCCCAAA	293t
mixed_CGAGATTGCTAGAC	293t
mixed_CGAGATTGTGGTCA	293t
mixed_CGAGCCGAAGTCAC	293t
mixed_CGAGCCGATTCAGG	293t
mixed_CGAGCGTGCCTAAG	293t
mixed_CGAGGAGAAGAAGT	jurkat
mixed_CGAGGAGACCAAGT	293t
mixed_CGAGGAGATTCTCA	jurkat
mixed_CGAGGCACATGCCA	jurkat
mixed_CGAGGCACCCATAG	jurkat
mixed_CGAGGCTGCATTGG	jurkat
mixed_CGAGGCTGTCGCCT	jurkat
mixed_CGAGGCTGTGCTGA	293t
mixed_CGAGGGCTCAAAGA	293t
mixed_CGAGGGCTGTCTAG	jurkat
mixed_CGAGTATGAGAACA	293t
mixed_CGAGTATGGGAAGC	jurkat
mixed_CGATACGAGCTACA	293t
mixed_CGATACGATCAAGC	293t
mixed_CGATACGATCTATC	jurkat
mixed_CGATAGACGTTACG	293t
mixed_CGATCAGAAGCAAA	293t
mixed_CGATCAGAAGCTAC	jurkat
mixed_CGATCCACGGTCTA	jurkat
mixed_CGCAACCTTTGAGC	293t
mixed_CGCACGGAAGAGGC	jurkat
mixed_CGCACGGAGCTAAC	293t
mixed_CGCACGGAGGGATG	293t
mixed_CGCACTACCTGACA	jurkat
mixed_CGCACTTGTTCTTG	jurkat
mixed_CGCAGGACCCACCT	jurkat
mixed_CGCAGGACTCGCCT	jurkat
mixed_CGCATAGAACCAAC	293t
mixed_CGCCATACACTCAG	jurkat
mixed_CGCCATACGCTACA	jurkat
mixed_CGCCATTGGCCATA	jurkat
mixed_CGCCATTGGTTGTG	jurkat
mixed_CGCCGAGAAGATGA	293t
mixed_CGCGAGACCATGGT	293t
mixed_CGCGAGACGGACTT	jurkat
mixed_CGCGAGACTCCCAC	jurkat
mixed_CGCGATCTTGAGCT	jurkat
mixed_CGCGGATGACCAGT	jurkat
mixed_CGCGGATGCCTTCG	293t
mixed_CGCGGATGGGCGAA	jurkat
mixed_CGCGGATGTGCCCT	jurkat
mixed_CGCTAAGAGGAACG	293t
mixed_CGCTACACGGAAGC	293t
mixed_CGCTACACTTATCC	jurkat
mixed_CGCTACACTTGTCT	jurkat
mixed_CGCTACTGAGCTCA	293t
mixed_CGCTACTGCCCAAA	jurkat
mixed_CGCTACTGTATGCG	jurkat
mixed_CGCTCATGCTCATT	293t
mixed_CGGAATTGGTAAGA	293t
mixed_CGGACCGATAAAGG	293t
mixed_CGGACCGATGCCTC	jurkat
mixed_CGGACCGATTCTCA	jurkat
mixed_CGGACTCTAGTACC	293t
mixed_CGGACTCTATCGTG	jurkat
mixed_CGGACTCTGTCACA	jurkat
mixed_CGGACTCTTTTGGG	jurkat
mixed_CGGATAACATTTCC	293t
mixed_CGGATAACGTCGTA	jurkat
mixed_CGGCACGAATCGAC	jurkat
mixed_CGGCACGACCTCGT	293t
mixed_CGGCACGATGGATC	jurkat
mixed_CGGCATCTCTTACT	jurkat
mixed_CGGCATCTGCAGTT	jurkat
mixed_CGGCATCTGCTTAG	293t
mixed_CGGCATCTTCGATG	jurkat
mixed_CGGCCAGAAGCCAT	293t
mixed_CGGCCAGAGTTCGA	jurkat
mixed_CGGCGAACCAAAGA	293t
mixed_CGGCGAACCCACAA	jurkat
mixed_CGGCGAACGTCTGA	jurkat
mixed_CGGCGATGCTCGAA	293t
mixed_CGGGACTGACCTTT	293t
mixed_CGGGACTGGCCTTC	jurkat
mixed_CGGGACTGTCTACT	293t
mixed_CGGGACTGTGTGGT	jurkat
mixed_CGGGCATGCCGATA	jurkat
mixed_CGGGCATGGGAAGC	jurkat
mixed_CGGGCATGGGTAAA	jurkat
mixed_CGGTAAACGGTGGA	jurkat
mixed_CGGTAAACTCACCC	293t
mixed_CGGTAAACTTACTC	jurkat
mixed_CGGTACCTTTTACC	jurkat
mixed_CGTAACGACCTTTA	jurkat
mixed_CGTAACGACGAGAG	jurkat
mixed_CGTAACGATGTAGC	jurkat
mixed_CGTACCACCTACCC	jurkat
mixed_CGTACCTGGCGAAG	293t
mixed_CGTAGCCTACAGTC	293t
mixed_CGTAGCCTAGCGGA	293t
mixed_CGTAGCCTCCTAAG	293t
mixed_CGTAGCCTTACTCT	293t
mixed_CGTCAAGACATACG	293t
mixed_CGTCAAGACTAGTG	293t
mixed_CGTCAAGAGTTCAG	jurkat
mixed_CGTCAAGATGGAAA	jurkat
mixed_CGTCCAACAAGATG	293t
mixed_CGTCCAACGGCATT	jurkat
mixed_CGTCCATGCGTTAG	293t
mixed_CGTCCATGTCTTCA	jurkat
mixed_CGTCCATGTGAAGA	293t
mixed_CGTCGACTGATAAG	jurkat
mixed_CGTGAAACTACGCA	293t
mixed_CGTGAATGAGCCTA	jurkat
mixed_CGTGAATGCCAACA	293t
mixed_CGTGAATGCTGTAG	jurkat
mixed_CGTGAATGTGGTCA	jurkat
mixed_CGTGATGACAAAGA	jurkat
mixed_CGTGATGACCATAG	jurkat
mixed_CGTGATGACTGAGT	jurkat
mixed_CGTGATGAGGGTGA	293t
mixed_CGTGCACTTGAAGA	jurkat
mixed_CGTTAGGACTCGAA	jurkat
mixed_CGTTATACGAGGAC	jurkat
mixed_CGTTATACGCTCCT	jurkat
mixed_CGTTATACGTAAAG	293t
mixed_CGTTTAACCAATCG	293t
mixed_CGTTTAACCATTCT	jurkat
mixed_CGTTTAACGGTATC	293t
mixed_CGTTTAACTTACTC	jurkat
mixed_CTAAACCTCGTAGT	jurkat
mixed_CTAACACTAAGCAA	293t
mixed_CTAACACTAGTAGA	jurkat
mixed_CTAACACTGTAGCT	jurkat
mixed_CTAACGGACAATCG	293t
mixed_CTAACGGACAGTTG	293t
mixed_CTAACGGACGACAT	jurkat
mixed_CTAACGGAGGAGTG	293t
mixed_CTAACGGAGTCGTA	293t
mixed_CTAACGGATGTTCT	293t
mixed_CTAACTACTAGCGT	jurkat
mixed_CTAAGGACGAAGGC	jurkat
mixed_CTAAGGACGGATTC	293t
mixed_CTAAGGTGACGACT	293t
mixed_CTAAGGTGCAGAGG	jurkat
mixed_CTAAGGTGCCTTTA	jurkat
mixed_CTAAGGTGCGTAAC	jurkat
mixed_CTAAGGTGGTCCTC	293t
mixed_CTAAGGTGGTGTTG	293t
mixed_CTAAGGTGTACGAC	jurkat
mixed_CTAATAGAAGCCAT	jurkat
mixed_CTAATAGAATCGGT	jurkat
mixed_CTAATAGATAGTCG	293t
mixed_CTAATGCTATTCTC	293t
mixed_CTAATGCTCAGTTG	jurkat
mixed_CTACAACTAACCAC	jurkat
mixed_CTACAACTTTCTAC	293t
mixed_CTACCTCTCGCAAT	293t
mixed_CTACCTCTTCACCC	jurkat
mixed_CTACGCACGAGACG	jurkat
mixed_CTACGCACTCGCAA	jurkat
mixed_CTACGGCTACTGTG	jurkat
mixed_CTACGGCTCGCATA	293t
mixed_CTACGGCTGGGTGA	293t
mixed_CTACTATGACGGAG	293t
mixed_CTACTATGCACAAC	jurkat
mixed_CTACTATGCATACG	jurkat
mixed_CTACTCCTATGACC	293t
mixed_CTACTCCTCTGAGT	jurkat
mixed_CTACTCCTTCTCAT	jurkat
mixed_CTAGAGACCCCGTT	jurkat
mixed_CTAGAGACCCTCAC	293t
mixed_CTAGAGACTATGGC	jurkat
mixed_CTAGAGACTCGTTT	jurkat
mixed_CTAGATCTGTACGT	jurkat
mixed_CTAGGATGCGAACT	jurkat
mixed_CTAGGATGCTTCTA	293t
mixed_CTAGGATGGGTGGA	293t
mixed_CTAGGATGTGTTCT	293t
mixed_CTAGGCCTAGAACA	293t
mixed_CTAGGCCTCGTGTA	293t
mixed_CTAGGTGAGGCATT	293t
mixed_CTAGGTGATTCTTG	jurkat
mixed_CTAGGTGATTTCAC	jurkat
mixed_CTAGTTACTTCATC	jurkat
mixed_CTAGTTTGACTGTG	jurkat
mixed_CTAGTTTGATTCCT	jurkat
mixed_CTATAAGAATTCCT	jurkat
mixed_CTATAAGAGAGGGT	293t
mixed_CTATACTGCGCTAA	jurkat
mixed_CTATACTGTCGCAA	jurkat
mixed_CTATAGCTTCCTTA	293t
mixed_CTATCATGGAACCT	jurkat
mixed_CTATCATGTTACTC	jurkat
mixed_CTATCCCTACTGTG	jurkat
mixed_CTATCCCTATTTCC	293t
mixed_CTATCCCTCCTAAG	293t
mixed_CTATCCCTGGCAAG	jurkat
mixed_CTATCCCTTGCAGT	jurkat
mixed_CTATGTACACTCAG	jurkat
mixed_CTATGTACAGCGGA	293t
mixed_CTATGTTGACCTCC	293t
mixed_CTATTGACGCTATG	293t
mixed_CTATTGACTTCATC	jurkat
mixed_CTATTGTGCATTGG	jurkat
mixed_CTCAATTGAAACAG	jurkat
mixed_CTCAATTGCTACGA	jurkat
mixed_CTCAATTGGACTAC	jurkat
mixed_CTCAATTGTGACAC	293t
mixed_CTCAGAGAGAGATA	jurkat
mixed_CTCAGCACCATGAC	293t
mixed_CTCAGCACTCGCCT	jurkat
mixed_CTCAGCTGAGCAAA	293t
mixed_CTCAGCTGTGTCGA	jurkat
mixed_CTCAGGCTGGTTTG	293t
mixed_CTCATTGACAGGAG	jurkat
mixed_CTCCACGACCTTCG	293t
mixed_CTCCATCTACAGCT	jurkat
mixed_CTCCATCTATCGTG	293t
mixed_CTCCATCTGCATCA	293t
mixed_CTCCATCTGTAGCT	jurkat
mixed_CTCCGAACATTCCT	jurkat
mixed_CTCCGAACGAATAG	jurkat
mixed_CTCCGAACGGGTGA	jurkat
mixed_CTCCGAACGTTCGA	293t
mixed_CTCCTACTCTGCAA	jurkat
mixed_CTCCTACTGTTACG	293t
mixed_CTCGAAGACTGCAA	293t
mixed_CTCGACACTCAAGC	293t
mixed_CTCGACACTGGTAC	jurkat
mixed_CTCGACTGACGGTT	293t
mixed_CTCGACTGACTGGT	jurkat
mixed_CTCGACTGTAACGC	293t
mixed_CTCGACTGTACTGG	293t
mixed_CTCGAGCTTGCGTA	293t
mixed_CTCGCATGCCTCCA	jurkat
mixed_CTCGCATGCTCTTA	jurkat
mixed_CTCGCATGGTCCTC	293t
mixed_CTCGCATGTGACAC	293t
mixed_CTCTAAACACGTAC	293t
mixed_CTCTAAACGACGTT	293t
mixed_CTCTAAACGTGAGG	293t
mixed_CTCTAATGTCTCAT	293t
mixed_CTGAACGAGTCACA	293t
mixed_CTGAACGAGTCTTT	jurkat
mixed_CTGAACGATAGACC	293t
mixed_CTGAAGACCCTATT	293t
mixed_CTGAAGACGAGCAG	jurkat
mixed_CTGAAGACGCTGAT	293t
mixed_CTGAAGACGTATCG	293t
mixed_CTGAAGTGACTACG	293t
mixed_CTGAAGTGCCAAGT	293t
mixed_CTGAAGTGGGTAGG	jurkat
mixed_CTGAAGTGTTATCC	293t
mixed_CTGAATCTGCAGTT	jurkat
mixed_CTGAATCTGGCATT	293t
mixed_CTGAATCTGGTCTA	jurkat
mixed_CTGACCACAAAACG	jurkat
mixed_CTGACCACACGCTA	jurkat
mixed_CTGACCACTCCCAC	jurkat
mixed_CTGAGAACCTATTC	jurkat
mixed_CTGAGCCTACCTAG	293t
mixed_CTGAGCCTGCGGAA	jurkat
mixed_CTGAGCCTGGTTCA	293t
mixed_CTGAGCCTTGGGAG	293t
mixed_CTGATGGAACGACT	293t
mixed_CTGATGGAAGGGTG	293t
mixed_CTGATGGACGTCTC	jurkat
mixed_CTGATGGAGGTCTA	293t
mixed_CTGATTTGTTCTGT	jurkat
mixed_CTGCAGCTGACAGG	293t
mixed_CTGCCAACGAACCT	293t
mixed_CTGCCAACTCCTTA	jurkat
mixed_CTGCGACTTTCTTG	jurkat
mixed_CTGGAAACAACTGC	jurkat
mixed_CTGGAAACCGGAGA	293t
mixed_CTGGAAACGCTGAT	293t
mixed_CTGGAAACGTTGGT	293t
mixed_CTGGATGAAGTAGA	293t
mixed_CTGGATGACACTGA	jurkat
mixed_CTGGCACTTGCTAG	293t
mixed_CTGTATACAGCATC	293t
mixed_CTGTATACCTGTGA	293t
mixed_CTTAAAGAACGACT	293t
mixed_CTTAAAGACAAGCT	jurkat
mixed_CTTAAAGAGTACCA	jurkat
mixed_CTTAAAGATAGAAG	293t
mixed_CTTAAAGATCCCGT	293t
mixed_CTTAAAGATGCAGT	jurkat
mixed_CTTAACACAATCGC	jurkat
mixed_CTTAACACATGTGC	293t
mixed_CTTAACACGCAGTT	293t
mixed_CTTAAGCTAGCCTA	jurkat
mixed_CTTAAGCTGCAGTT	293t
mixed_CTTACAACGGAGTG	293t
mixed_CTTACAACTAAGCC	293t
mixed_CTTACATGAAACGA	jurkat
mixed_CTTACTGATCTACT	jurkat
mixed_CTTAGACTACGCTA	293t
mixed_CTTAGACTATTTCC	293t
mixed_CTTAGACTTGCTCC	293t
mixed_CTTAGACTTGGGAG	293t
mixed_CTTATCGATGTTCT	293t
mixed_CTTCACCTGGGACA	jurkat
mixed_CTTCATGAATGACC	jurkat
mixed_CTTCATGATGGTCA	jurkat
mixed_CTTCTAGAACCAGT	293t
mixed_CTTCTAGAAGTCTG	293t
mixed_CTTCTAGACCGTTC	jurkat
mixed_CTTCTAGACTTGAG	293t
mixed_CTTCTAGAGCCAAT	293t
mixed_CTTGAACTACGACT	jurkat
mixed_CTTGAACTCATTGG	293t
mixed_CTTGAGGACAGAGG	293t
mixed_CTTGATTGGACACT	jurkat
mixed_CTTGATTGTCTCCG	293t
mixed_CTTGATTGTTCTAC	293t
mixed_CTTTACGAACGCAT	jurkat
mixed_CTTTACGACCGCTT	293t
mixed_CTTTAGACACGCTA	jurkat
mixed_CTTTAGACTCTCGC	jurkat
mixed_CTTTAGTGATCGTG	jurkat
mixed_CTTTCAGAATGACC	293t
mixed_CTTTCAGAGAGACG	293t
mixed_CTTTGATGGGCATT	293t
mixed_GAAACCTGCGTTGA	jurkat
mixed_GAAACCTGGTTAGC	jurkat
mixed_GAAAGATGACCTGA	293t
mixed_GAAAGATGCAACTG	293t
mixed_GAAAGATGCTCGAA	jurkat
mixed_GAAAGCCTTAAGCC	293t
mixed_GAAAGTGACTCCCA	jurkat
mixed_GAAATACTACCTGA	293t
mixed_GAAATACTGTTGCA	jurkat
mixed_GAACACACATTTCC	jurkat
mixed_GAACACACGCTACA	jurkat
mixed_GAACACACGGATCT	jurkat
mixed_GAACACACTGCTCC	293t
mixed_GAACAGCTAACCAC	jurkat
mixed_GAACAGCTCACCAA	jurkat
mixed_GAACAGCTGACAAA	293t
mixed_GAACCAACCCTCGT	jurkat
mixed_GAACGGGACCATGA	293t
mixed_GAACGTTGCGTTGA	jurkat
mixed_GAACGTTGCTCAGA	jurkat
mixed_GAACTGTGGGTAAA	jurkat
mixed_GAACTGTGGTTAGC	jurkat
mixed_GAAGATGAACAGCT	jurkat
mixed_GAAGATGAACCGAT	jurkat
mixed_GAAGCGGACTCTTA	293t
mixed_GAAGCGGAGGTCTA	293t
mixed_GAAGCTACGAATCC	293t
mixed_GAAGCTTGACTTTC	293t
mixed_GAAGCTTGGCTCCT	jurkat
mixed_GAAGCTTGTGCCCT	jurkat
mixed_GAAGGGTGACAGTC	jurkat
mixed_GAAGGGTGCACAAC	jurkat
mixed_GAAGGGTGCTACGA	jurkat
mixed_GAAGGGTGCTTAGG	jurkat
mixed_GAAGGGTGGTATCG	293t
mixed_GAAGGTCTACCCAA	293t
mixed_GAAGGTCTCAGATC	jurkat
mixed_GAAGGTCTCCCACT	jurkat
mixed_GAAGGTCTCTCAAG	jurkat
mixed_GAAGGTCTCTCAGA	293t
mixed_GAAGGTCTTCAAGC	jurkat
mixed_GAAGTAGACATCAG	293t
mixed_GAAGTAGACCCTTG	293t
mixed_GAAGTCACCGTACA	jurkat
mixed_GAAGTCACGGAAGC	293t
mixed_GAAGTCACGTTACG	293t
mixed_GAAGTCACTACGCA	jurkat
mixed_GAAGTCTGCACACA	293t
mixed_GAAGTCTGCGACAT	jurkat
mixed_GAAGTCTGGCCTTC	293t
mixed_GAAGTGCTGCCATA	jurkat
mixed_GAAGTGCTGGAGCA	293t
mixed_GAAGTGCTGGTAGG	293t
mixed_GAAGTGCTTCCGAA	jurkat
mixed_GAAGTGCTTGGAGG	293t
mixed_GAAGTGCTTTACTC	293t
mixed_GAATGCACACTACG	293t
mixed_GAATGCTGGGAGGT	jurkat
mixed_GAATGGCTAGGAGC	jurkat
mixed_GAATGGCTGGTAAA	jurkat
mixed_GACAACACAACGAA	293t
mixed_GACAACACACTACG	jurkat
mixed_GACAACACCCAAGT	jurkat
mixed_GACAACACCGATAC	293t
mixed_GACAACACGCGATT	jurkat
mixed_GACAACACGCGTAT	jurkat
mixed_GACAACACGGAGCA	jurkat
mixed_GACAACTGACGACT	293t
mixed_GACAACTGATTGGC	293t
mixed_GACAACTGCCACAA	293t
mixed_GACAACTGCGAGAG	293t
mixed_GACAACTGGTACCA	jurkat
mixed_GACACTGATTACTC	jurkat
mixed_GACAGGGAGCATCA	jurkat
mixed_GACAGGGAGGTCTA	jurkat
mixed_GACAGGGATGGAGG	jurkat
mixed_GACAGTACACCAAC	293t
mixed_GACAGTACGGCATT	293t
mixed_GACAGTACTAAAGG	jurkat
mixed_GACAGTTGACGCAT	jurkat
mixed_GACAGTTGCAGTTG	293t
mixed_GACAGTTGTCAGTG	jurkat
mixed_GACATTCTCGATAC	293t
mixed_GACATTCTGCCAAT	293t
mixed_GACATTCTTGAAGA	jurkat
mixed_GACATTCTTGCTCC	jurkat
mixed_GACCAAACACCACA	293t
mixed_GACCAAACCAACCA	293t
mixed_GACCAAACGGAAGC	jurkat
mixed_GACCAAACTACTCT	293t
mixed_GACCATGAAGGGTG	293t
mixed_GACCATGACCATAG	jurkat
mixed_GACCATGACCATGA	293t
mixed_GACCATGAGAAAGT	293t
mixed_GACCCTACACCAAC	jurkat
mixed_GACCCTACCTCTTA	jurkat
mixed_GACCCTACCTGTCC	293t
mixed_GACCCTACTTTGGG	293t
mixed_GACCTAGAAACTGC	293t
mixed_GACCTAGAAGCTAC	293t
mixed_GACCTCACCGTGAT	293t
mixed_GACCTCTGGCTAAC	293t
mixed_GACGAACTTAGTCG	293t
mixed_GACGATTGATGTGC	jurkat
mixed_GACGATTGTCCTGC	293t
mixed_GACGCCGACCAATG	jurkat
mixed_GACGCCGATTTCAC	293t
mixed_GACGCTCTCCTTCG	293t
mixed_GACGGCACGAATCC	jurkat
mixed_GACGTAACGCAGAG	jurkat
mixed_GACGTATGTTATCC	293t
mixed_GACGTCCTGAGAGC	jurkat
mixed_GACGTCCTGGAAGC	293t
mixed_GACTCCTGGGTCAT	jurkat
mixed_GACTGAACAGAGAT	jurkat
mixed_GACTGAACCTTCTA	jurkat
mixed_GACTGAACCTTTAC	jurkat
mixed_GACTGAACGATAGA	293t
mixed_GACTGATGATGCCA	293t
mixed_GACTGATGTCGCCT	293t
mixed_GACTTTACAAACAG	293t
mixed_GACTTTACACCAGT	293t
mixed_GAGAAATGAGCGTT	293t
mixed_GAGAAATGGAACTC	293t
mixed_GAGAAATGTAGAGA	jurkat
mixed_GAGAGGTGCGACTA	jurkat
mixed_GAGAGGTGGTGTCA	293t
mixed_GAGAGGTGTCGTGA	jurkat
mixed_GAGATCACATTGGC	jurkat
mixed_GAGATCACTCCTGC	jurkat
mixed_GAGATCACTGAGAA	293t
mixed_GAGATCACTGCCTC	jurkat
mixed_GAGATGCTCCGTTC	293t
mixed_GAGATGCTCGAGTT	jurkat
mixed_GAGCAGGACTCAAG	jurkat
mixed_GAGCAGGAGAGGCA	jurkat
mixed_GAGCAGGAGCGTTA	jurkat
mixed_GAGCGAGAGGACTT	jurkat
mixed_GAGCGCACAGAAGT	jurkat
mixed_GAGCGCACCTGTCC	293t
mixed_GAGCGCTGGGCAAG	293t
mixed_GAGCGCTGTGGTCA	jurkat
mixed_GAGCGGCTTGCTTT	jurkat
mixed_GAGCTCCTACCCTC	293t
mixed_GAGCTCCTGTCGAT	jurkat
mixed_GAGGATCTCTTCGC	jurkat
mixed_GAGGCAGACGTAAC	jurkat
mixed_GAGGCAGATGCTCC	293t
mixed_GAGGCCACGGAACG	jurkat
mixed_GAGGGAACATTCCT	293t
mixed_GAGGGAACTTCGTT	jurkat
mixed_GAGGGCCTACCCTC	293t
mixed_GAGGGTGAGAGGTG	293t
mixed_GAGGTACTATCACG	293t
mixed_GAGGTACTTAAGCC	293t
mixed_GAGGTACTTGTTTC	jurkat
mixed_GAGGTGGACTCTTA	jurkat
mixed_GAGGTGGATAGAAG	jurkat
mixed_GAGGTGGATCCTGC	293t
mixed_GAGGTGGATCTAGG	jurkat
mixed_GAGGTGGATGCTGA	293t
mixed_GAGGTTACATAAGG	293t
mixed_GAGGTTACCTGAAC	293t
mixed_GAGGTTACTACTCT	293t
mixed_GAGGTTACTCCCGT	jurkat
mixed_GAGGTTACTGCACA	jurkat
mixed_GAGGTTACTGCCCT	293t
mixed_GAGTAAGACGGGAA	jurkat
mixed_GAGTAAGATCATTC	jurkat
mixed_GAGTACACCCGCTT	jurkat
mixed_GAGTACACCCTCGT	293t
mixed_GAGTACACTCGATG	293t
mixed_GAGTACACTGCCCT	293t
mixed_GAGTACTGGGTTAC	293t
mixed_GAGTACTGTGCTTT	293t
mixed_GAGTCAACTTCACT	293t
mixed_GAGTCAACTTCGTT	293t
mixed_GAGTCTGAGTCGTA	293t
mixed_GAGTGACTGCCAAT	jurkat
mixed_GAGTGACTGGTGTT	jurkat
mixed_GAGTGGGAATTGGC	jurkat
mixed_GAGTGGGAGGATCT	jurkat
mixed_GAGTTGTGAAGAGT	jurkat
mixed_GAGTTGTGCCCTTG	293t
mixed_GAGTTGTGGAGCAG	293t
mixed_GATAAGGAACACCA	293t
mixed_GATAATACAGACTC	jurkat
mixed_GATAATACCTAGCA	293t
mixed_GATAATACTCCGTC	jurkat
mixed_GATACTCTTAACGC	jurkat
mixed_GATACTCTTCGATG	293t
mixed_GATAGAGAACGTTG	jurkat
mixed_GATAGAGAGTCACA	293t
mixed_GATAGCACCGTGAT	jurkat
mixed_GATAGCACGGGATG	jurkat
mixed_GATAGCACGGTCAT	293t
mixed_GATAGCACGGTTAC	jurkat
mixed_GATATATGACGCTA	293t
mixed_GATATATGATCTCT	jurkat
mixed_GATATATGGACTAC	jurkat
mixed_GATATATGGATAAG	293t
mixed_GATATCCTCACTAG	293t
mixed_GATATTGAAGTCAC	293t
mixed_GATATTGAGGCAAG	jurkat
mixed_GATATTGATCGATG	293t
mixed_GATATTGATGACCA	jurkat
mixed_GATATTGATGGCAT	293t
mixed_GATCATCTGTGCTA	jurkat
mixed_GATCATCTTTGGCA	jurkat
mixed_GATCCCTGTGCATG	jurkat
mixed_GATCCCTGTTGCGA	293t
mixed_GATCCGCTAAAACG	293t
mixed_GATCCGCTCAGAGG	293t
mixed_GATCGAACAAGTGA	293t
mixed_GATCGATGGGTCTA	jurkat
mixed_GATCGATGGTCACA	jurkat
mixed_GATCGTGAAGTGTC	jurkat
mixed_GATCTACTGAGGAC	jurkat
mixed_GATCTTACTACGCA	jurkat
mixed_GATCTTTGCGGTAT	293t
mixed_GATGACACAAAACG	jurkat
mixed_GATGACACGGACAG	jurkat
mixed_GATGCAACAGATGA	293t
mixed_GATGCAACCTAGAC	293t
mixed_GATGCAACCTTACT	jurkat
mixed_GATGCAACGTACAC	jurkat
mixed_GATGCATGAATGCC	jurkat
mixed_GATGCATGACTCTT	293t
mixed_GATGCATGAGTGCT	293t
mixed_GATGCATGGCCCTT	jurkat
mixed_GATGCCCTATAAGG	jurkat
mixed_GATGCCCTGAATCC	jurkat
mixed_GATGCCCTGCCAAT	293t
mixed_GATGCCCTGGAAAT	293t
mixed_GATTACCTGAGGTG	293t
mixed_GATTACCTGCCTTC	293t
mixed_GATTACCTTGAAGA	293t
mixed_GATTCGGAAGAACA	293t
mixed_GATTCGGATCACGA	293t
mixed_GATTCGGATGAAGA	jurkat
mixed_GATTCGGATTTCAC	jurkat
mixed_GATTCTACCCTCAC	293t
mixed_GATTCTACGGTGTT	jurkat
mixed_GATTCTTGAAGCCT	jurkat
mixed_GATTCTTGCACACA	jurkat
mixed_GATTCTTGCTGAGT	293t
mixed_GATTCTTGTGACAC	jurkat
mixed_GATTGGACATTCGG	293t
mixed_GATTGGACCGCCTT	293t
mixed_GATTGGACCTTAGG	jurkat
mixed_GATTGGACGCAGTT	293t
mixed_GATTGGACGTAAGA	293t
mixed_GATTGGACTTGACG	jurkat
mixed_GATTGGTGTCGCTC	jurkat
mixed_GATTGGTGTGCTCC	293t
mixed_GATTTGCTCCATAG	293t
mixed_GATTTGCTGGAAAT	jurkat
mixed_GCAACCCTCTTTAC	293t
mixed_GCAACCCTTACTCT	293t
mixed_GCAACCCTTTCCGC	jurkat
mixed_GCAACTGAGGGACA	293t
mixed_GCAAGACTAAGATG	293t
mixed_GCAAGACTCGCTAA	jurkat
mixed_GCAAGACTCTTGCC	jurkat
mixed_GCAAGACTGCGATT	293t
mixed_GCAAGACTTAAAGG	293t
mixed_GCAAGACTTGCATG	293t
mixed_GCAAGACTTTCACT	jurkat
mixed_GCAATCGATCCCGT	jurkat
mixed_GCAATCGATGTCTT	293t
mixed_GCAATTCTAACGAA	293t
mixed_GCAATTCTCCAATG	jurkat
mixed_GCAATTCTCGATAC	293t
mixed_GCAATTCTGCTAAC	jurkat
mixed_GCAATTCTTCTTAC	293t
mixed_GCACAAACTCTCTA	293t
mixed_GCACAATGAGTGTC	293t
mixed_GCACAATGGGGATG	jurkat
mixed_GCACACCTACACCA	293t
mixed_GCACACCTACGTAC	293t
mixed_GCACACCTCTTGGA	jurkat
mixed_GCACCACTCCATAG	jurkat
mixed_GCACCACTTAGCCA	293t
mixed_GCACCTACCAGCTA	jurkat
mixed_GCACCTACCCACAA	293t
mixed_GCACCTTGGAGGGT	jurkat
mixed_GCACGGACCAGGAG	293t
mixed_GCACGGACCGTGTA	293t
mixed_GCACGGACTCTACT	jurkat
mixed_GCACGGTGAAACGA	jurkat
mixed_GCACGGTGACGCTA	293t
mixed_GCACGGTGATTCCT	jurkat
mixed_GCACGGTGATTCGG	jurkat
mixed_GCACGGTGCAGGAG	jurkat
mixed_GCACGGTGCGCTAA	jurkat
mixed_GCACTAGACTTATC	293t
mixed_GCAGATACACACAC	293t
mixed_GCAGATACTGCTGA	293t
mixed_GCAGATACTTCTGT	jurkat
mixed_GCAGCCGACCGCTT	jurkat
mixed_GCAGCCGACGTTAG	jurkat
mixed_GCAGCCGATCGCAA	293t
mixed_GCAGCGTGTGGTGT	jurkat
mixed_GCAGCTCTGCTATG	jurkat
mixed_GCAGCTCTTTCCGC	293t
mixed_GCAGGCACGTCTTT	293t
mixed_GCAGGGCTTCCGAA	293t
mixed_GCAGGGCTTCGTTT	293t
mixed_GCAGGGCTTGGATC	jurkat
mixed_GCAGTCCTAAGCCT	jurkat
mixed_GCAGTCCTAGTGCT	jurkat
mixed_GCAGTTGAACTACG	jurkat
mixed_GCAGTTGACCACCT	293t
mixed_GCAGTTGACTTGAG	293t
mixed_GCATCAGACCTCGT	jurkat
mixed_GCATCAGAGAAACA	jurkat
mixed_GCATCAGATCGCCT	jurkat
mixed_GCATGATGAAGGGC	jurkat
mixed_GCATGATGACCTGA	293t
mixed_GCATGATGGCTACA	jurkat
mixed_GCATGTGAGCTGAT	jurkat
mixed_GCATGTGATGCATG	293t
mixed_GCATTGGAAGCTAC	293t
mixed_GCATTGGACATTCT	293t
mixed_GCATTGGAGGCAAG	jurkat
mixed_GCCAAAACACCAGT	293t
mixed_GCCAAAACATCGAC	293t
mixed_GCCAAAACCCAACA	jurkat
mixed_GCCAAAACGTCTGA	293t
mixed_GCCAAAACTCAGGT	jurkat
mixed_GCCAAAACTGATGC	293t
mixed_GCCAAATGGCCCTT	jurkat
mixed_GCCAAATGGGTTTG	jurkat
mixed_GCCAAATGTACGCA	293t
mixed_GCCAACCTCAACCA	293t
mixed_GCCAACCTTGGTTG	jurkat
mixed_GCCAACCTTGTGAC	jurkat
mixed_GCCACGGACTGTTT	293t
mixed_GCCACGGATAAGGA	jurkat
mixed_GCCACTACACGCAT	293t
mixed_GCCACTACTAACCG	293t
mixed_GCCATGCTCCGAAT	jurkat
mixed_GCCATGCTCCTGAA	293t
mixed_GCCATGCTCCTTCG	293t
mixed_GCCATGCTCTCGCT	293t
mixed_GCCCAACTCTAGAC	jurkat
mixed_GCCCAGGAGACTAC	293t
mixed_GCCCATACCCTCAC	jurkat
mixed_GCCCATACGCATAC	jurkat
mixed_GCCGACGAAAAGCA	jurkat
mixed_GCCGACGACCCACT	jurkat
mixed_GCCGAGTGCACTTT	293t
mixed_GCCGAGTGCCTCCA	jurkat
mixed_GCCGGAACCGGGAA	jurkat
mixed_GCCGTACTAGGTTC	jurkat
mixed_GCCGTACTCGCTAA	jurkat
mixed_GCCGTACTTGAGAA	jurkat
mixed_GCCGTACTTTTCAC	293t
mixed_GCCTACACATCACG	293t
mixed_GCCTACACGTTTGG	jurkat
mixed_GCCTAGCTACGGGA	293t
mixed_GCCTAGCTATCAGC	jurkat
mixed_GCCTAGCTCAAGCT	jurkat
mixed_GCCTAGCTGTGAGG	293t
mixed_GCCTCAACCGCAAT	293t
mixed_GCCTCATGATGTGC	jurkat
mixed_GCCTCATGCCTCGT	293t
mixed_GCCTCATGGCATCA	jurkat
mixed_GCCTCATGGGTAAA	293t
mixed_GCCTCATGTACTCT	jurkat
mixed_GCCTGACTAGCCTA	jurkat
mixed_GCGAAGGAGCGTTA	293t
mixed_GCGAGAGACATTGG	293t
mixed_GCGAGAGATGGTAC	293t
mixed_GCGAGCACATTCGG	jurkat
mixed_GCGAGCACTAGAAG	293t
mixed_GCGAGCACTGCATG	293t
mixed_GCGATATGCTGATG	293t
mixed_GCGATATGGACGTT	jurkat
mixed_GCGATATGGTCAAC	jurkat
mixed_GCGATATGGTGCTA	293t
mixed_GCGATATGTGTCCC	293t
mixed_GCGATATGTTCCAT	293t
mixed_GCGCACGAAAGAAC	293t
mixed_GCGCACGACTGATG	293t
mixed_GCGCACGATGCTCC	293t
mixed_GCGCATCTCGCAAT	jurkat
mixed_GCGCATCTGCCATA	293t
mixed_GCGCGAACGGTCTA	293t
mixed_GCGCGATGCCACCT	jurkat
mixed_GCGCGATGCCGTAA	293t
mixed_GCGCGATGCCTCAC	jurkat
mixed_GCGGACTGAACCGT	jurkat
mixed_GCGGACTGCCTTGC	jurkat
mixed_GCGGCAACGAACTC	293t
mixed_GCGGGACTCCTGAA	293t
mixed_GCGGGACTGTGTAC	jurkat
mixed_GCGGGACTGTTTGG	293t
mixed_GCGTAAACGGTTAC	293t
mixed_GCGTAAACTGGCAT	293t
mixed_GCGTAATGCTGCAA	jurkat
mixed_GCGTAATGGGGTGA	jurkat
mixed_GCGTAATGTCTTTG	293t
mixed_GCGTACCTATGTGC	jurkat
mixed_GCGTACCTCTGGTA	jurkat
mixed_GCGTACCTGACGAG	jurkat
mixed_GCGTACCTGGTTTG	jurkat
mixed_GCGTATGAAACTGC	293t
mixed_GCGTATGACAGAGG	jurkat
mixed_GCGTATGACCTTGC	jurkat
mixed_GCGTATGAGACAAA	jurkat
mixed_GCGTATGATTGCTT	293t
mixed_GCTACAGACACTAG	jurkat
mixed_GCTACAGATGTTTC	jurkat
mixed_GCTACAGATTGCGA	293t
mixed_GCTACCTGATGCCA	293t
mixed_GCTACCTGCTGTAG	293t
mixed_GCTACGCTGTGTAC	293t
mixed_GCTAGAACCATTCT	293t
mixed_GCTAGAACCCATAG	jurkat
mixed_GCTAGAACGAGCAG	293t
mixed_GCTAGAACGCGATT	293t
mixed_GCTAGATGACACCA	jurkat
mixed_GCTAGATGCCGATA	jurkat
mixed_GCTAGATGCGACAT	jurkat
mixed_GCTAGATGGGGTGA	293t
mixed_GCTAGATGTCTATC	jurkat
mixed_GCTATACTAAGGCG	293t
mixed_GCTATACTCACCAA	jurkat
mixed_GCTCAAGACGACTA	jurkat
mixed_GCTCAGCTCCATGA	293t
mixed_GCTCAGCTGGAGTG	293t
mixed_GCTCAGCTGTCAAC	jurkat
mixed_GCTCCATGTGTCCC	jurkat
mixed_GCTCGACTTTCGCC	293t
mixed_GCTGATGATGGTTG	jurkat
mixed_GCTGATGATTAGGC	jurkat
mixed_GCTTAACTCTTTAC	jurkat
mixed_GCTTAACTGAATAG	293t
mixed_GCTTAACTTGCTTT	jurkat
mixed_GCTTGAGATGCGTA	jurkat
mixed_GGAACACTCATGCA	jurkat
mixed_GGAACTTGAAGGGC	jurkat
mixed_GGAACTTGTCCTTA	jurkat
mixed_GGAAGGACCGTGTA	jurkat
mixed_GGAAGGACTCCTGC	293t
mixed_GGAAGGTGACAGCT	jurkat
mixed_GGAAGGTGACGTAC	293t
mixed_GGAAGGTGGTTACG	293t
mixed_GGAATCTGTACTGG	jurkat
mixed_GGAATGCTACGCAT	293t
mixed_GGAATGCTTATCGG	jurkat
mixed_GGACAACTCACCAA	jurkat
mixed_GGACAACTCCAACA	jurkat
mixed_GGACAACTCTGGAT	jurkat
mixed_GGACAGGAAGGTCT	293t
mixed_GGACAGGAAGTCGT	293t
mixed_GGACAGGACTCTCG	jurkat
mixed_GGACATTGCCTATT	jurkat
mixed_GGACCCGAAGTCAC	293t
mixed_GGACCCGACGGAGA	293t
mixed_GGACCGTGCGATAC	jurkat
mixed_GGACCGTGCTTATC	293t
mixed_GGACCGTGGACGGA	jurkat
mixed_GGACCTCTAACTGC	jurkat
mixed_GGACGAGAAGCGTT	jurkat
mixed_GGACGAGAGACAGG	293t
mixed_GGACGCACCACTAG	293t
mixed_GGACGCACCATGCA	293t
mixed_GGACGCACGCTGTA	jurkat
mixed_GGACGCACTCGTTT	293t
mixed_GGACGCTGACCTTT	293t
mixed_GGACGCTGATTCGG	293t
mixed_GGACGCTGGATAAG	293t
mixed_GGACGCTGGTCAAC	jurkat
mixed_GGACTATGATACCG	293t
mixed_GGACTATGCCTGTC	293t
mixed_GGACTATGTCCCAC	293t
mixed_GGACTATGTCTAGG	jurkat
mixed_GGAGACGAACACTG	jurkat
mixed_GGAGAGACAGATGA	jurkat
mixed_GGAGAGACGCAGTT	jurkat
mixed_GGAGCCACCATCAG	293t
mixed_GGAGCGCTACACAC	jurkat
mixed_GGAGCGCTCGACAT	293t
mixed_GGAGCGCTTGAGAA	jurkat
mixed_GGAGGCCTTCCTCG	293t
mixed_GGAGGCCTTCTACT	jurkat
mixed_GGAGGCCTTGCGTA	293t
mixed_GGAGGTGAGCGTAT	293t
mixed_GGAGTTACCATGGT	293t
mixed_GGAGTTACTATTCC	293t
mixed_GGAGTTACTCCTCG	293t
mixed_GGAGTTACTTCCGC	293t
mixed_GGAGTTTGAGTGCT	jurkat
mixed_GGAGTTTGCCCAAA	jurkat
mixed_GGATACTGAGCCTA	jurkat
mixed_GGATACTGGAGAGC	jurkat
mixed_GGATACTGTTGTCT	293t
mixed_GGATAGCTCAGATC	jurkat
mixed_GGATAGCTGAACCT	293t
mixed_GGATAGCTTCGACA	jurkat
mixed_GGATGTACGTGCAT	293t
mixed_GGATGTTGAACGAA	jurkat
mixed_GGATTGTGTCCTAT	jurkat
mixed_GGATTTCTTCCAGA	293t
mixed_GGCACTCTGGAAAT	jurkat
mixed_GGCACTCTGGAACG	jurkat
mixed_GGCACTCTGTTGGT	jurkat
mixed_GGCATATGCTGGAT	jurkat
mixed_GGCATATGGGTGAG	jurkat
mixed_GGCATATGGTTAGC	293t
mixed_GGCATATGTACTTC	jurkat
mixed_GGCATATGTTACTC	293t
mixed_GGCCACGAAGAACA	293t
mixed_GGCCACGACCGATA	293t
mixed_GGCCACGAGGTTAC	jurkat
mixed_GGCCAGACAAAACG	293t
mixed_GGCCAGACGTGCTA	jurkat
mixed_GGCCAGACTATGCG	jurkat
mixed_GGCCCAGAGCAGTT	293t
mixed_GGCCCAGATGCCTC	jurkat
mixed_GGCCGAACACGTGT	293t
mixed_GGCCGAACAGTAGA	jurkat
mixed_GGCCGAACGTCTTT	jurkat
mixed_GGCCGATGAAGCCT	293t
mixed_GGCCGATGATGACC	jurkat
mixed_GGCGCATGAGCATC	jurkat
mixed_GGCGCATGCGCTAA	293t
mixed_GGCGCATGCTCATT	293t
mixed_GGCGCATGGTTTGG	293t
mixed_GGCGGACTTCCTAT	293t
mixed_GGCGGACTTGATGC	jurkat
mixed_GGCTAAACATCAGC	jurkat
mixed_GGCTAAACGCCATA	jurkat
mixed_GGCTAATGAGAAGT	293t
mixed_GGCTAATGCTCTCG	jurkat
mixed_GGCTAATGGGAGCA	293t
mixed_GGCTAATGGTTGCA	293t
mixed_GGCTACCTGACGTT	jurkat
mixed_GGCTCACTCTCGCT	jurkat
mixed_GGGAACGACAAAGA	293t
mixed_GGGAAGACCGTGTA	jurkat
mixed_GGGAAGACGAAACA	293t
mixed_GGGAAGACGTCACA	293t
mixed_GGGAAGACTGAACC	293t
mixed_GGGAAGACTTCACT	jurkat
mixed_GGGAAGTGAAAACG	293t
mixed_GGGAAGTGATGTCG	jurkat
mixed_GGGAAGTGGGCAAG	jurkat
mixed_GGGAAGTGTAGAAG	293t
mixed_GGGAAGTGTCTATC	293t
mixed_GGGACCACCAGCTA	jurkat
mixed_GGGACCTGGTCAAC	293t
mixed_GGGACCTGTCGTAG	jurkat
mixed_GGGATGGACCGAAT	293t
mixed_GGGATGGACTGCTC	jurkat
mixed_GGGATTACCCGTAA	293t
mixed_GGGATTACGTAGCT	293t
mixed_GGGCAAGAATCGGT	jurkat
mixed_GGGCAAGACGAATC	jurkat
mixed_GGGCAAGACGACAT	jurkat
mixed_GGGCACACAGTACC	jurkat
mixed_GGGCACACTGTAGC	jurkat
mixed_GGGCAGCTCAGAAA	293t
mixed_GGGCAGCTCTCAGA	293t
mixed_GGGCAGCTCTCCAC	jurkat
mixed_GGGCAGCTTTCTTG	jurkat
mixed_GGGCCAACCAGTTG	293t
mixed_GGGCCAACCGTAGT	jurkat
mixed_GGGCCAACTACGCA	jurkat
mixed_GGGCCATGGGAGTG	293t
mixed_GGGCCATGGGCGAA	jurkat
mixed_GGGTAACTATCACG	293t
mixed_GGGTAACTCCTCAC	jurkat
mixed_GGGTAACTGTGTTG	jurkat
mixed_GGGTTATGCGGAGA	jurkat
mixed_GGGTTATGTAGAGA	jurkat
mixed_GGGTTATGTCGTGA	jurkat
mixed_GGGTTATGTTGTGG	293t
mixed_GGTAAAGACTGTCC	293t
mixed_GGTAAAGAGTTAGC	293t
mixed_GGTACAACACCCAA	293t
mixed_GGTACATGGCTGTA	293t
mixed_GGTACATGGGTTCA	293t
mixed_GGTACATGTCGTTT	293t
mixed_GGTACTGAAGCCAT	jurkat
mixed_GGTACTGAGGTTAC	jurkat
mixed_GGTACTGAGGTTTG	jurkat
mixed_GGTACTGATTCCCG	jurkat
mixed_GGTAGTACCTCGAA	jurkat
mixed_GGTAGTACTGTCTT	jurkat
mixed_GGTATCGATTTGTC	293t
mixed_GGTATGACACCCAA	293t
mixed_GGTATGACATCGAC	293t
mixed_GGTATGACCGTGAT	293t
mixed_GGTATGACGGTAAA	jurkat
mixed_GGTATGACTGGAAA	293t
mixed_GGTATGACTGTCGA	jurkat
mixed_GGTCAAACGGAAGC	jurkat
mixed_GGTCAAACTGTGGT	jurkat
mixed_GGTCTAGAACTAGC	jurkat
mixed_GGTCTAGATGGTCA	jurkat
mixed_GGTCTAGATGGTGT	jurkat
mixed_GGTGATACGACGAG	jurkat
mixed_GGTGGAGACTCAGA	293t
mixed_GGTTGAACGAAGGC	293t
mixed_GGTTTACTACCTCC	jurkat
mixed_GGTTTACTGGGATG	293t
mixed_GGTTTACTTCCGAA	293t
mixed_GTAACGTGACAGCT	293t
mixed_GTAACGTGACCTTT	293t
mixed_GTAACGTGCTTATC	293t
mixed_GTAACGTGGAAAGT	jurkat
mixed_GTAAGCACAAAAGC	jurkat
mixed_GTAAGCACATGGTC	jurkat
mixed_GTAAGCACGCATCA	jurkat
mixed_GTAAGCACTGACAC	jurkat
mixed_GTAAGCACTTCATC	293t
mixed_GTAAGCTGCCTGTC	jurkat
mixed_GTAAGCTGGAATCC	jurkat
mixed_GTAAGCTGGAGGTG	293t
mixed_GTAATAACACGGGA	293t
mixed_GTAATAACGAGGAC	jurkat
mixed_GTAATAACTGCCTC	jurkat
mixed_GTAATAACTGGAGG	jurkat
mixed_GTAATATGGTTGTG	jurkat
mixed_GTACCCTGGCTACA	293t
mixed_GTACGAACCACCAA	jurkat
mixed_GTACGAACCACTAG	jurkat
mixed_GTACGAACTGCCAA	jurkat
mixed_GTACGAACTGCTCC	293t
mixed_GTACTTTGAGTACC	293t
mixed_GTACTTTGCAGATC	293t
mixed_GTACTTTGGGACAG	293t
mixed_GTAGACTGCTCGCT	jurkat
mixed_GTAGACTGTCCCAC	jurkat
mixed_GTAGCAACGTGTTG	jurkat
mixed_GTAGCAACGTTTGG	jurkat
mixed_GTAGCAACTGACTG	jurkat
mixed_GTAGCAACTGGAAA	jurkat
mixed_GTAGCATGACAGCT	jurkat
mixed_GTAGCATGGAACCT	jurkat
mixed_GTAGCATGGCAGTT	293t
mixed_GTAGCATGTGGATC	293t
mixed_GTAGCCCTACAGCT	293t
mixed_GTAGCCCTACTCAG	jurkat
mixed_GTAGCCCTCTCCCA	jurkat
mixed_GTAGCCCTTATTCC	jurkat
mixed_GTAGCTGATTCATC	jurkat
mixed_GTAGGTACACTACG	293t
mixed_GTAGGTACCGTAGT	jurkat
mixed_GTAGGTACTCTGGA	jurkat
mixed_GTAGTCGAGGTTTG	jurkat
mixed_GTAGTCGAGTATCG	293t
mixed_GTAGTCGATGCTAG	293t
mixed_GTAGTCGATGTCAG	jurkat
mixed_GTAGTGACTCCAGA	293t
mixed_GTAGTGTGCACTGA	jurkat
mixed_GTAGTGTGGTCTAG	293t
mixed_GTATCACTAACGGG	jurkat
mixed_GTATCACTTCCTCG	jurkat
mixed_GTATCTACAGTACC	jurkat
mixed_GTATCTACTGAAGA	293t
mixed_GTATCTACTTACTC	jurkat
mixed_GTATGGTGAGATCC	jurkat
mixed_GTATGGTGCGTAAC	jurkat
mixed_GTATGGTGGTACGT	293t
mixed_GTATTAGATCGCCT	293t
mixed_GTATTCACATAAGG	jurkat
mixed_GTATTCACTCATTC	293t
mixed_GTCAACGACATTTC	293t
mixed_GTCAACGAGGATCT	293t
mixed_GTCAACGATGCAAC	jurkat
mixed_GTCACAGACCACCT	293t
mixed_GTCACAGATGTGCA	jurkat
mixed_GTCATACTATCGGT	293t
mixed_GTCATACTCAGTCA	293t
mixed_GTCCAAGATAAGGA	jurkat
mixed_GTCCAAGATTGTGG	jurkat
mixed_GTCCACACAGAACA	jurkat
mixed_GTCCACACCGTAAC	293t
mixed_GTCCACACCTTCGC	jurkat
mixed_GTCCACTGGGTCAT	293t
mixed_GTCCACTGTATTCC	293t
mixed_GTCCCATGCCAACA	293t
mixed_GTCCCATGTGTCAG	jurkat
mixed_GTCGAATGACACGT	jurkat
mixed_GTCGAATGATTGGC	jurkat
mixed_GTCGAATGTAAGGA	jurkat
mixed_GTCGAATGTGCTTT	293t
mixed_GTCGCACTATCGTG	293t
mixed_GTCTAGGAGGAGCA	293t
mixed_GTCTAGGAGGCATT	293t
mixed_GTCTAGGATCGTGA	293t
mixed_GTCTGAGACCAACA	jurkat
mixed_GTCTGAGAGGACTT	jurkat
mixed_GTGAACACAGCCTA	jurkat
mixed_GTGAACACGAGGTG	293t
mixed_GTGAGGGAAGGAGC	jurkat
mixed_GTGATCGAACGTAC	jurkat
mixed_GTGATCGAGAAGGC	jurkat
mixed_GTGATCGATCCCGT	jurkat
mixed_GTGCAAACAGCGGA	293t
mixed_GTGCAAACCCCACT	jurkat
mixed_GTGCAAACTGTTTC	jurkat
mixed_GTGCCACTATCGGT	293t
mixed_GTGCCACTCAACCA	jurkat
mixed_GTGCCACTGGTAAA	jurkat
mixed_GTGCCACTTACTCT	293t
mixed_GTGCTAGAAAGGGC	jurkat
mixed_GTGCTAGACTGATG	293t
mixed_GTGCTAGATGCAGT	293t
mixed_GTGCTAGATTCCCG	293t
mixed_GTGGAGGACACAAC	jurkat
mixed_GTGGAGGACTGTGA	jurkat
mixed_GTGGAGGACTGTTT	293t
mixed_GTGGTAACATAAGG	jurkat
mixed_GTGGTAACGAATCC	jurkat
mixed_GTGGTAACTAACCG	jurkat
mixed_GTGGTAACTGCTGA	jurkat
mixed_GTGTACGACGGTAT	293t
mixed_GTGTACGAGTCCTC	jurkat
mixed_GTGTACGATCACGA	jurkat
mixed_GTGTACGATGTAGC	293t
mixed_GTGTAGTGCTTCTA	jurkat
mixed_GTGTAGTGGGGCAA	jurkat
mixed_GTGTATCTAATGCC	jurkat
mixed_GTGTATCTCGAGTT	jurkat
mixed_GTGTATCTGACGTT	jurkat
mixed_GTGTCAGACTACCC	293t
mixed_GTGTGATGGGATTC	jurkat
mixed_GTTAAAACGGCAAG	jurkat
mixed_GTTAAAACGTAAAG	293t
mixed_GTTAACCTTTGGTG	293t
mixed_GTTACGGAATGACC	jurkat
mixed_GTTACGGACCTGTC	jurkat
mixed_GTTACGGAGCAGTT	jurkat
mixed_GTTACGGATTGTCT	293t
mixed_GTTACTACTCCAGA	293t
mixed_GTTACTACTCTCTA	jurkat
mixed_GTTACTACTTCGCC	293t
mixed_GTTAGGTGGACGAG	293t
mixed_GTTATAGACACAAC	jurkat
mixed_GTTATAGACTGCTC	293t
mixed_GTTATAGATGTAGC	293t
mixed_GTTATCTGCGCAAT	293t
mixed_GTTATCTGTACTCT	jurkat
mixed_GTTATGCTCTCTCG	jurkat
mixed_GTTATGCTGCTATG	jurkat
mixed_GTTCAACTAGCTCA	jurkat
mixed_GTTCAACTTCACCC	jurkat
mixed_GTTCAACTTCGTGA	jurkat
mixed_GTTCATACCACTTT	293t
mixed_GTTCATACTACTTC	jurkat
mixed_GTTCATACTGTAGC	293t
mixed_GTTGACGATTTCGT	jurkat
mixed_GTTGAGTGCCGTAA	293t
mixed_GTTGAGTGGCCTTC	293t
mixed_GTTGAGTGGGAAGC	jurkat
mixed_GTTGAGTGTGGAAA	293t
mixed_GTTGATCTCTTACT	293t
mixed_GTTGATCTGTCTAG	jurkat
mixed_GTTGATCTTCGTGA	293t
mixed_GTTGGATGCCTCCA	jurkat
mixed_GTTGGATGCGTTGA	jurkat
mixed_GTTGGATGGCAAGG	293t
mixed_GTTGGATGGTGCTA	jurkat
mixed_GTTGTACTGGAAAT	jurkat
mixed_GTTGTACTTTATCC	jurkat
mixed_TAAACAACTCTTAC	293t
mixed_TAAACAACTGGGAG	293t
mixed_TAAAGACTACGGAG	jurkat
mixed_TAAAGACTTACTTC	293t
mixed_TAAAGTTGCTACTT	jurkat
mixed_TAAAGTTGTCGCTC	293t
mixed_TAAAGTTGTGAGCT	293t
mixed_TAAATCGAAGTCTG	293t
mixed_TAAATCGAGAATAG	293t
mixed_TAAATGTGCTCCAC	jurkat
mixed_TAAATGTGGTCATG	jurkat
mixed_TAACAATGCTGCTC	293t
mixed_TAACAATGTAGAGA	293t
mixed_TAACAATGTCTTAC	293t
mixed_TAACACCTACCTCC	jurkat
mixed_TAACACCTCAGTCA	jurkat
mixed_TAACACCTGTAAAG	jurkat
mixed_TAACCGGAAATGCC	293t
mixed_TAACCGGAGTGCTA	jurkat
mixed_TAACGTCTTGGTTG	293t
mixed_TAACGTCTTGTCGA	jurkat
mixed_TAACGTCTTTTCGT	jurkat
mixed_TAACTAGAAGTCTG	jurkat
mixed_TAACTAGACCTTTA	293t
mixed_TAACTAGAGTATGC	jurkat
mixed_TAACTAGATTGGTG	293t
mixed_TAAGAGGAAAAGCA	jurkat
mixed_TAAGAGGAAAGGTA	293t
mixed_TAAGAGGACGACAT	293t
mixed_TAAGAGGAGGAGTG	jurkat
mixed_TAAGAGGAGTCTTT	293t
mixed_TAAGAGGATGCCTC	293t
mixed_TAAGATACACCTTT	293t
mixed_TAAGATACACTGGT	293t
mixed_TAAGATACAGTCAC	jurkat
mixed_TAAGATACCAACCA	293t
mixed_TAAGATACTGGTCA	jurkat
mixed_TAAGATTGCGGGAA	293t
mixed_TAAGATTGCGTAAC	293t
mixed_TAAGATTGTGGTCA	293t
mixed_TAAGATTGTGTGCA	jurkat
mixed_TAAGCTCTACACGT	293t
mixed_TAAGCTCTTGCTAG	293t
mixed_TAAGGCTGGACGAG	293t
mixed_TAAGGGCTATGCTG	jurkat
mixed_TAAGGGCTGTATGC	293t
mixed_TAAGTAACGAGCAG	jurkat
mixed_TAAGTCCTCCAACA	jurkat
mixed_TAAGTCCTTAGCCA	293t
mixed_TAATCCACTGCCAA	293t
mixed_TAATCCACTTGCTT	jurkat
mixed_TAATCGCTCTGGTA	293t
mixed_TAATGAACCCCACT	293t
mixed_TAATGAACGCTTCC	293t
mixed_TAATGAACGTAAGA	293t
mixed_TAATGATGCCTTCG	293t
mixed_TAATGATGCTAGAC	293t
mixed_TAATGATGCTTGTT	293t
mixed_TAATGATGTGCCCT	293t
mixed_TAATGCCTCCATGA	jurkat
mixed_TAATGCCTCTTATC	293t
mixed_TAATGCCTTACTGG	293t
mixed_TAATGTGACCAACA	jurkat
mixed_TACACACTCTTAGG	jurkat
mixed_TACACACTGGAAAT	jurkat
mixed_TACACACTGGAGCA	jurkat
mixed_TACACACTGGTGGA	293t
mixed_TACACACTTGTCGA	293t
mixed_TACATAGACGCATA	jurkat
mixed_TACATAGAGCGAGA	jurkat
mixed_TACATAGATTGTGG	293t
mixed_TACATCACCTATGG	293t
mixed_TACATCACGAGAGC	293t
mixed_TACCATTGGAATAG	293t
mixed_TACCATTGGGTACT	jurkat
mixed_TACCATTGTGGCAT	jurkat
mixed_TACCGAGATGCCCT	293t
mixed_TACCGCTGCATACG	jurkat
mixed_TACCGCTGCCGAAT	293t
mixed_TACCGCTGCTTGAG	jurkat
mixed_TACCGGCTGTGAGG	293t
mixed_TACCGGCTTTGGTG	jurkat
mixed_TACGACGACCCACT	293t
mixed_TACGACGAGCCATA	jurkat
mixed_TACGAGTGCACTTT	293t
mixed_TACGAGTGTTAGGC	jurkat
mixed_TACGATCTCTGCAA	293t
mixed_TACGATCTGGATCT	jurkat
mixed_TACGCAGACTGAAC	jurkat
mixed_TACGCAGAGGTGAG	293t
mixed_TACGCCACCAAGCT	293t
mixed_TACGCCACTACGCA	jurkat
mixed_TACGGAACCATGGT	jurkat
mixed_TACGGCCTACACTG	jurkat
mixed_TACGGCCTACTTTC	jurkat
mixed_TACGGCCTGACTAC	jurkat
mixed_TACGTACTACCAGT	jurkat
mixed_TACGTACTCGATAC	293t
mixed_TACGTACTGGACGA	293t
mixed_TACGTACTGTTCTT	293t
mixed_TACGTACTTTCTTG	jurkat
mixed_TACGTTACATGACC	293t
mixed_TACTACACCCATAG	jurkat
mixed_TACTACTGGGAGCA	jurkat
mixed_TACTACTGTTGACG	293t
mixed_TACTCAACCTTGGA	jurkat
mixed_TACTCAACGAATAG	jurkat
mixed_TACTCCCTAGAGGC	293t
mixed_TACTCCCTGGAGTG	293t
mixed_TACTCCCTTCCCGT	293t
mixed_TACTCTGATGTTTC	jurkat
mixed_TACTTGACACCGAT	293t
mixed_TACTTGACCTGGTA	jurkat
mixed_TACTTGACGACGGA	293t
mixed_TACTTTCTGACAGG	jurkat
mixed_TACTTTCTTTTACC	jurkat
mixed_TAGAAACTTAGACC	jurkat
mixed_TAGAGAGAAAAAGC	293t
mixed_TAGAGAGACGACAT	293t
mixed_TAGAGAGAGTTGCA	293t
mixed_TAGAGCACATGCCA	jurkat
mixed_TAGATCCTCGCATA	jurkat
mixed_TAGATCCTCGCCTT	jurkat
mixed_TAGATTGAGGCGAA	293t
mixed_TAGATTGATCTAGG	jurkat
mixed_TAGCATCTCGTGAT	jurkat
mixed_TAGCATCTGTTAGC	293t
mixed_TAGCATCTTCTAGG	jurkat
mixed_TAGCCCACCAGCTA	jurkat
mixed_TAGCCCACTAACCG	jurkat
mixed_TAGCCCTGAAGCAA	293t
mixed_TAGCCCTGCCATGA	jurkat
mixed_TAGCCCTGCCTCCA	jurkat
mixed_TAGCCCTGCGTAAC	293t
mixed_TAGCCCTGGATAGA	jurkat
mixed_TAGCCCTGTCGATG	293t
mixed_TAGCCGCTCATGAC	293t
mixed_TAGCCGCTCTACGA	jurkat
mixed_TAGCCGCTTGAACC	293t
mixed_TAGCTACTCACACA	jurkat
mixed_TAGCTACTGGACTT	293t
mixed_TAGGACTGACTCTT	293t
mixed_TAGGACTGGTAAAG	jurkat
mixed_TAGGAGCTCCAACA	jurkat
mixed_TAGGAGCTTAAAGG	jurkat
mixed_TAGGAGCTTGACCA	293t
mixed_TAGGCAACGATACC	293t
mixed_TAGGCAACTAGCGT	293t
mixed_TAGGCATGACACAC	293t
mixed_TAGGCATGAGTTCG	jurkat
mixed_TAGGCATGTCGTGA	293t
mixed_TAGGCTGACTCAAG	jurkat
mixed_TAGGCTGATGCGTA	293t
mixed_TAGGGACTATAAGG	jurkat
mixed_TAGGGACTCGACTA	jurkat
mixed_TAGGTCGAAACGTC	jurkat
mixed_TAGGTCGAAAGCAA	jurkat
mixed_TAGGTCGAGACACT	jurkat
mixed_TAGGTCGAGCGTAT	jurkat
mixed_TAGGTGACCGATAC	jurkat
mixed_TAGGTGACGCAGTT	293t
mixed_TAGGTGACGGGATG	jurkat
mixed_TAGGTGACTGACTG	jurkat
mixed_TAGGTGACTGTCAG	jurkat
mixed_TAGGTGTGAATGCC	jurkat
mixed_TAGGTTCTACTAGC	293t
mixed_TAGGTTCTATCAGC	293t
mixed_TAGGTTCTGAGCTT	293t
mixed_TAGGTTCTTCGCTC	jurkat
mixed_TAGTAAACAAGGTA	293t
mixed_TAGTAAACCTACGA	jurkat
mixed_TAGTAAACGGTAAA	jurkat
mixed_TAGTAATGCAAAGA	jurkat
mixed_TAGTAATGGGGCAA	jurkat
mixed_TAGTACCTAGCACT	jurkat
mixed_TAGTACCTCAGAGG	jurkat
mixed_TAGTACCTCCACAA	293t
mixed_TAGTATGACACTAG	jurkat
mixed_TAGTCACTCTGATG	293t
mixed_TAGTCACTGCTATG	293t
mixed_TAGTCACTTGCCAA	293t
mixed_TAGTCGGAAGAGAT	293t
mixed_TAGTCGGAGTTTCT	293t
mixed_TAGTCTTGGGAGTG	293t
mixed_TAGTCTTGTTGGTG	jurkat
mixed_TAGTTAGACCCTAC	293t
mixed_TAGTTCACACCTGA	293t
mixed_TAGTTCACGTAAGA	jurkat
mixed_TATAAGACCATCAG	293t
mixed_TATAAGTGAGTCAC	jurkat
mixed_TATAAGTGCACTTT	jurkat
mixed_TATACAGAGTGTTG	293t
mixed_TATACCACGTTACG	293t
mixed_TATACGCTCTTGGA	jurkat
mixed_TATACGCTGGTAGG	293t
mixed_TATACGCTTCCCGT	jurkat
mixed_TATAGATGAGTGTC	293t
mixed_TATAGCCTCCCAAA	293t
mixed_TATAGCCTCCCACT	293t
mixed_TATAGCCTCCTGTC	jurkat
mixed_TATAGCCTCCTTGC	293t
mixed_TATAGCCTGGGATG	293t
mixed_TATCAAGAATTCCT	293t
mixed_TATCAAGATCGCCT	293t
mixed_TATCACTGAAAAGC	293t
mixed_TATCACTGAAGATG	jurkat
mixed_TATCACTGCAAGCT	293t
mixed_TATCACTGCGGAGA	jurkat
mixed_TATCACTGGTAGCT	293t
mixed_TATCACTGTATTCC	jurkat
mixed_TATCACTGTCTTCA	jurkat
mixed_TATCAGCTGGTAGG	jurkat
mixed_TATCAGCTGTCACA	jurkat
mixed_TATCCAACTGCGTA	293t
mixed_TATCCAACTTACTC	293t
mixed_TATCCTGAAACCAC	jurkat
mixed_TATCCTGATGTCGA	jurkat
mixed_TATCCTGATGTGCA	293t
mixed_TATCCTGATTTGCT	293t
mixed_TATCGACTACTAGC	jurkat
mixed_TATCGACTGGTGGA	293t
mixed_TATCGACTTTCTCA	jurkat
mixed_TATCGTACAACGAA	jurkat
mixed_TATCGTACAGTCTG	jurkat
mixed_TATCGTACTGACTG	293t
mixed_TATCGTACTTCGTT	293t
mixed_TATCTCGAAGTACC	293t
mixed_TATCTCGACTCAAG	jurkat
mixed_TATCTCGAGTAGGG	293t
mixed_TATCTGACGGACTT	jurkat
mixed_TATCTTCTAAACGA	jurkat
mixed_TATCTTCTACCCAA	293t
mixed_TATCTTCTACTACG	293t
mixed_TATCTTCTCTACCC	293t
mixed_TATCTTCTTAAGCC	jurkat
mixed_TATCTTCTTCCTAT	293t
mixed_TATGAATGCTCAGA	jurkat
mixed_TATGAATGGAACCT	293t
mixed_TATGAATGGACGTT	293t
mixed_TATGAATGGCATCA	jurkat
mixed_TATGAATGTCTCCG	jurkat
mixed_TATGCGGAGGAGTG	293t
mixed_TATGCGGAGGTGAG	293t
mixed_TATGCGGATCAAGC	293t
mixed_TATGGGACACGGTT	293t
mixed_TATGGTCTAGTAGA	jurkat
mixed_TATGGTCTATTGGC	jurkat
mixed_TATGGTCTGCTAAC	jurkat
mixed_TATGTCACCTGCAA	jurkat
mixed_TATGTCTGAACCAC	293t
mixed_TATGTCTGACCTCC	jurkat
mixed_TATGTGCTGATAGA	jurkat
mixed_TATTTCCTAGATCC	293t
mixed_TCAAGGACAGAACA	293t
mixed_TCAAGGACGAACCT	293t
mixed_TCAAGGTGAAGTGA	jurkat
mixed_TCAAGGTGACACAC	jurkat
mixed_TCAAGGTGTCGATG	293t
mixed_TCAAGTCTCTCATT	jurkat
mixed_TCAAGTCTGACGTT	jurkat
mixed_TCAAGTCTTGAACC	jurkat
mixed_TCAAGTCTTGCAAC	jurkat
mixed_TCAATAGAAGTACC	jurkat
mixed_TCAATCACAAGGTA	jurkat
mixed_TCAATCACAGTTCG	293t
mixed_TCAATCACCCGTTC	jurkat
mixed_TCAATCACGTTGGT	jurkat
mixed_TCACAACTAGTGTC	293t
mixed_TCACAACTGCGTAT	jurkat
mixed_TCACATACAACCTG	jurkat
mixed_TCACATACCGTGTA	293t
mixed_TCACCCGACAGAAA	293t
mixed_TCACCCGAGAAAGT	293t
mixed_TCACCCGAGAATAG	293t
mixed_TCACCCGAGCGATT	jurkat
mixed_TCACCCGATTCACT	jurkat
mixed_TCACCGTGCCGTTC	293t
mixed_TCACCGTGGGAGTG	jurkat
mixed_TCACCTCTCGTTGA	293t
mixed_TCACTATGACGCAT	293t
mixed_TCACTATGGGAGCA	293t
mixed_TCAGACGAGCGATT	293t
mixed_TCAGAGACCTATGG	293t
mixed_TCAGAGACGGACTT	293t
mixed_TCAGAGACTTTCGT	jurkat
mixed_TCAGCAGACAGCTA	293t
mixed_TCAGCAGACGTACA	293t
mixed_TCAGCAGACTTCCG	jurkat
mixed_TCAGCGCTTGGAAA	293t
mixed_TCAGGATGATCGTG	jurkat
mixed_TCAGGATGGTGAGG	jurkat
mixed_TCAGTACTAGATGA	jurkat
mixed_TCAGTACTCCCGTT	jurkat
mixed_TCAGTGGAATGCCA	293t
mixed_TCAGTGGACTTACT	jurkat
mixed_TCAGTTACGCTGAT	jurkat
mixed_TCAGTTACTGCCAA	jurkat
mixed_TCATCAACCACACA	jurkat
mixed_TCATCAACGTTTCT	293t
mixed_TCATCATGAAACAG	jurkat
mixed_TCATCATGACTTTC	jurkat
mixed_TCATCATGCAAGCT	293t
mixed_TCATCATGCTGAAC	293t
mixed_TCATCATGTCGCTC	jurkat
mixed_TCATCATGTGCTAG	293t
mixed_TCATCCCTCATTCT	jurkat
mixed_TCATCCCTCGTGAT	293t
mixed_TCATCCCTGCTACA	293t
mixed_TCATCCCTTCCGTC	jurkat
mixed_TCATTCGAACACCA	293t
mixed_TCATTCGACAATCG	jurkat
mixed_TCATTGACGATACC	jurkat
mixed_TCCACGTGTTGACG	jurkat
mixed_TCCACTCTAAGCCT	293t
mixed_TCCACTCTACACAC	293t
mixed_TCCACTCTTTGAGC	jurkat
mixed_TCCAGAGAAGAGAT	293t
mixed_TCCAGAGACAGTCA	293t
mixed_TCCAGAGACTTCGC	293t
mixed_TCCAGAGAGAAAGT	jurkat
mixed_TCCAGAGAGTGTTG	293t
mixed_TCCAGAGATTGCTT	jurkat
mixed_TCCATAACCTAGCA	jurkat
mixed_TCCATAACGTCAAC	293t
mixed_TCCATCCTCCCTAC	293t
mixed_TCCATCCTCCGCTT	293t
mixed_TCCATCCTCGTACA	jurkat
mixed_TCCATCCTGCGTAT	293t
mixed_TCCATCCTGTAAAG	jurkat
mixed_TCCCACGAAGCATC	jurkat
mixed_TCCCACGACAGATC	293t
mixed_TCCCACGACCGTTC	jurkat
mixed_TCCCGATGGGTAAA	293t
mixed_TCCCGATGTAGTCG	jurkat
mixed_TCCCTACTGAGGAC	jurkat
mixed_TCCGAAGATTGACG	jurkat
mixed_TCCGAGCTCGACTA	jurkat
mixed_TCCGAGCTCGATAC	jurkat
mixed_TCCGAGCTGTTGCA	jurkat
mixed_TCCGAGCTTACTCT	jurkat
mixed_TCCGAGCTTCGCAA	293t
mixed_TCCGAGCTTGACCA	jurkat
mixed_TCCGGACTATAAGG	jurkat
mixed_TCCGGACTTGGTAC	293t
mixed_TCCTAAACACGCTA	293t
mixed_TCCTAAACCGTGAT	jurkat
mixed_TCCTAAACTTTCAC	jurkat
mixed_TCCTAATGATTCGG	jurkat
mixed_TCCTAATGTGGAAA	jurkat
mixed_TCCTATGAACTGTG	jurkat
mixed_TCCTATGAGATAAG	jurkat
mixed_TCGAATCTAGAGTA	jurkat
mixed_TCGAATCTTAGTCG	293t
mixed_TCGACCTGAACAGA	293t
mixed_TCGACCTGATGCCA	jurkat
mixed_TCGACCTGGTTGCA	jurkat
mixed_TCGACGCTACGTTG	jurkat
mixed_TCGACGCTTGGAGG	293t
mixed_TCGAGCCTAGAATG	jurkat
mixed_TCGATACTACTCAG	jurkat
mixed_TCGATTTGAGTGTC	jurkat
mixed_TCGATTTGCAGCTA	jurkat
mixed_TCGATTTGGCTTCC	jurkat
mixed_TCGATTTGTTCGCC	jurkat
mixed_TCGCAAGAAGTACC	jurkat
mixed_TCGCAAGACCTGAA	jurkat
mixed_TCGCAAGAGAATAG	293t
mixed_TCGCACACGGCGAA	293t
mixed_TCGCACTGCTGAAC	jurkat
mixed_TCGCACTGTTCGGA	293t
mixed_TCGCCATGAAGGTA	jurkat
mixed_TCGCCATGACAGTC	jurkat
mixed_TCGCCATGCACTTT	293t
mixed_TCGCCATGGCATCA	jurkat
mixed_TCGCCATGTAACGC	jurkat
mixed_TCGGACCTGTGTCA	jurkat
mixed_TCGGACCTTCAGGT	293t
mixed_TCGGCACTCGAGTT	293t
mixed_TCGGTAGAATCGTG	293t
mixed_TCGGTAGAGGAGGT	jurkat
mixed_TCGTGAGACACACA	293t
mixed_TCGTGAGATTTGGG	293t
mixed_TCGTTATGACCACA	293t
mixed_TCGTTATGCATCAG	293t
mixed_TCTAACACACCATG	293t
mixed_TCTAACACGAACCT	293t
mixed_TCTAACTGCAATCG	293t
mixed_TCTAACTGCCTATT	jurkat
mixed_TCTAACTGTTCGGA	jurkat
mixed_TCTAAGCTGAGGAC	jurkat
mixed_TCTAAGCTGCATAC	293t
mixed_TCTAGACTAAAAGC	293t
mixed_TCTAGACTGCTTAG	jurkat
mixed_TCTAGACTGTAAAG	jurkat
mixed_TCTAGACTTGACCA	jurkat
mixed_TCTAGTTGATCGGT	jurkat
mixed_TCTAGTTGCCGATA	293t
mixed_TCTAGTTGGCTAAC	jurkat
mixed_TCTAGTTGTGTCCC	293t
mixed_TCTAGTTGTGTGCA	jurkat
mixed_TCTATGTGAAGATG	293t
mixed_TCTATGTGGGTTCA	293t
mixed_TCTATGTGTAGAGA	jurkat
mixed_TCTCAAACACGCAT	293t
mixed_TCTCAAACGCCAAT	293t
mixed_TCTCCACTTCAGGT	293t
mixed_TCTCTAGACTAGTG	293t
mixed_TCTCTAGATCGCTC	293t
mixed_TCTGATACGGTGTT	jurkat
mixed_TCTGATACTACGAC	jurkat
mixed_TCTGATACTCGTGA	293t
mixed_TCTGATACTCTCTA	jurkat
mixed_TCTTACGAACTTTC	jurkat
mixed_TCTTACGATCGATG	293t
mixed_TCTTACGATTGGCA	293t
mixed_TCTTCAGATACAGC	293t
mixed_TCTTGATGTGCTCC	jurkat
mixed_TGAAATTGATCGGT	jurkat
mixed_TGAAATTGGACGTT	jurkat
mixed_TGAAATTGGTCTAG	jurkat
mixed_TGAACCGACCAGTA	jurkat
mixed_TGAACCGACTCATT	jurkat
mixed_TGAACCGACTTATC	293t
mixed_TGAAGCACCAAGCT	jurkat
mixed_TGAAGCACGCCAAT	jurkat
mixed_TGAAGCTGAGCTCA	jurkat
mixed_TGAAGCTGGCATCA	293t
mixed_TGAAGCTGGTCAAC	jurkat
mixed_TGAAGCTGTCGATG	jurkat
mixed_TGAATAACTTCTCA	293t
mixed_TGACCAGACTCTTA	293t
mixed_TGACCAGAGATAAG	jurkat
mixed_TGACCAGAGCGTTA	293t
mixed_TGACGAACACACAC	jurkat
mixed_TGACGAACGGTGGA	jurkat
mixed_TGACGAACTGAACC	jurkat
mixed_TGACGATGACACTG	293t
mixed_TGACGATGAGCATC	jurkat
mixed_TGACGATGCCTTTA	293t
mixed_TGACGATGCTACGA	jurkat
mixed_TGACGATGGCCCTT	293t
mixed_TGACGATGGTAGCT	293t
mixed_TGACGATGGTGTAC	293t
mixed_TGACGCCTCAACCA	293t
mixed_TGACGCCTGCTAAC	jurkat
mixed_TGACGCCTTAGACC	293t
mixed_TGACTGGACAGAAA	jurkat
mixed_TGACTGGACCATGA	293t
mixed_TGACTTACGATACC	293t
mixed_TGACTTACTTGCAG	293t
mixed_TGACTTACTTGTCT	293t
mixed_TGACTTTGAGCGTT	jurkat
mixed_TGAGACACATCAGC	293t
mixed_TGAGACACGGCGAA	293t
mixed_TGAGACACTAGCGT	jurkat
mixed_TGAGCAACACACTG	jurkat
mixed_TGAGCAACCGTACA	293t
mixed_TGAGGACTAACGAA	293t
mixed_TGAGGACTAGAGTA	293t
mixed_TGAGGACTCTCATT	jurkat
mixed_TGAGGACTGGTTTG	293t
mixed_TGAGGTACAGGTTC	293t
mixed_TGAGGTACCGTTGA	jurkat
mixed_TGAGGTACGCAAGG	jurkat
mixed_TGAGGTACGTATCG	293t
mixed_TGAGGTACGTTGGT	jurkat
mixed_TGAGGTACTTCAGG	jurkat
mixed_TGAGGTACTTGAGC	jurkat
mixed_TGAGTGACCTTCTA	293t
mixed_TGAGTGACGGGCAA	jurkat
mixed_TGAGTGACTACAGC	293t
mixed_TGAGTGACTGCTCC	293t
mixed_TGATAAACCGTAGT	jurkat
mixed_TGATAAACGATAGA	293t
mixed_TGATACCTACCCAA	jurkat
mixed_TGATACCTGTAGCT	293t
mixed_TGATATGATCGTGA	293t
mixed_TGATATGATGTCTT	293t
mixed_TGATCGGAAGAACA	jurkat
mixed_TGATCGGACAAAGA	jurkat
mixed_TGATCGGACCCGTT	jurkat
mixed_TGATTAGATATCGG	jurkat
mixed_TGATTCACGCTAAC	293t
mixed_TGATTCTGCCTCCA	jurkat
mixed_TGCAACGACTCGCT	jurkat
mixed_TGCAACGAGGACTT	293t
mixed_TGCAAGACGAAAGT	293t
mixed_TGCAAGACTTACCT	jurkat
mixed_TGCAAGTGAGCGGA	jurkat
mixed_TGCAAGTGATGTGC	jurkat
mixed_TGCAAGTGTGTCTT	293t
mixed_TGCAATCTACACTG	jurkat
mixed_TGCAATCTCCAACA	293t
mixed_TGCAATCTGAACTC	jurkat
mixed_TGCAATCTGCGAGA	293t
mixed_TGCACAGACGGAGA	jurkat
mixed_TGCACAGAGTTGCA	293t
mixed_TGCACAGATCGTGA	jurkat
mixed_TGCACGCTGGTCTA	jurkat
mixed_TGCAGATGATCAGC	293t
mixed_TGCAGATGCTTACT	jurkat
mixed_TGCAGATGGGTAAA	jurkat
mixed_TGCAGATGGGTAGG	jurkat
mixed_TGCCAAGAAGTGCT	jurkat
mixed_TGCCAAGAGAATCC	jurkat
mixed_TGCCAAGATCGTGA	jurkat
mixed_TGCCACTGAACAGA	jurkat
mixed_TGCCACTGATAAGG	293t
mixed_TGCCACTGGTGCTA	293t
mixed_TGCCAGCTCTGAGT	jurkat
mixed_TGCCCAACAAGATG	293t
mixed_TGCCCAACAGTGCT	293t
mixed_TGCCCAACTGTTTC	293t
mixed_TGCCGACTATCTCT	jurkat
mixed_TGCCGACTTGCTTT	jurkat
mixed_TGCGAAACCCACCT	jurkat
mixed_TGCGCACTTATGCG	jurkat
mixed_TGCGTAGAATCACG	jurkat
mixed_TGCGTAGACTGACA	jurkat
mixed_TGCTAGGAAAAGCA	293t
mixed_TGCTAGGATAACGC	293t
mixed_TGCTAGGATGTCGA	293t
mixed_TGCTGAGATATCGG	jurkat
mixed_TGCTGAGATTGGTG	293t
mixed_TGCTTAACCTGTGA	293t
mixed_TGCTTAACCTTGTT	293t
mixed_TGCTTAACTTACCT	jurkat
mixed_TGGAAAGAAGCGGA	jurkat
mixed_TGGAAAGAGGCATT	293t
mixed_TGGAACACACGTAC	293t
mixed_TGGAACACCCTTGC	jurkat
mixed_TGGAACACGAACTC	jurkat
mixed_TGGAACACGTCATG	jurkat
mixed_TGGAACACGTTTCT	jurkat
mixed_TGGAACTGAAAACG	jurkat
mixed_TGGAACTGATTCGG	jurkat
mixed_TGGAACTGTGCAGT	jurkat
mixed_TGGACCCTACGTTG	jurkat
mixed_TGGACCCTACTCAG	jurkat
mixed_TGGACCCTAGAAGT	293t
mixed_TGGACCCTTGGGAG	jurkat
mixed_TGGACTGAGTTCGA	293t
mixed_TGGAGACTCAGAGG	293t
mixed_TGGAGACTTGCAGT	293t
mixed_TGGAGGGACTGCAA	293t
mixed_TGGAGGGAGGACAG	jurkat
mixed_TGGAGGGAGGACGA	jurkat
mixed_TGGAGGGATCGCCT	jurkat
mixed_TGGATCGACAGATC	jurkat
mixed_TGGATCGATGAGCT	jurkat
mixed_TGGATGACACGTGT	293t
mixed_TGGATGACAGATCC	293t
mixed_TGGATGTGAACGAA	jurkat
mixed_TGGATGTGATCGAC	jurkat
mixed_TGGATGTGTGTCAG	293t
mixed_TGGATTCTGCGAAG	293t
mixed_TGGATTCTTCGTAG	jurkat
mixed_TGGCACCTATCTTC	293t
mixed_TGGCACCTGAGGTG	293t
mixed_TGGCACCTTGAGGG	jurkat
mixed_TGGGTATGGATGAA	293t
mixed_TGGGTATGGCCATA	293t
mixed_TGGGTATGGTTAGC	293t
mixed_TGGGTATGTCACCC	293t
mixed_TGGGTATGTGTCTT	293t
mixed_TGGTACGACCGCTT	jurkat
mixed_TGGTACGAGTAAGA	293t
mixed_TGGTACGAGTCCTC	293t
mixed_TGGTAGACGGTGGA	jurkat
mixed_TGGTAGTGCGCTAA	293t
mixed_TGGTAGTGGCTAAC	293t
mixed_TGGTATCTTTCTGT	293t
mixed_TGGTCAGACTGGAT	293t
mixed_TGGTTACTCGTACA	293t
mixed_TGTAAAACCATTTC	jurkat
mixed_TGTAAAACTTGCGA	293t
mixed_TGTAACCTACACTG	jurkat
mixed_TGTAACCTACTTTC	293t
mixed_TGTAATGACAACCA	jurkat
mixed_TGTAATGACTCGCT	293t
mixed_TGTAATGACTGACA	jurkat
mixed_TGTAATGATCTATC	293t
mixed_TGTACTTGACTAGC	jurkat
mixed_TGTACTTGGTCCTC	jurkat
mixed_TGTACTTGTAGCGT	293t
mixed_TGTAGGTGGATAGA	293t
mixed_TGTAGGTGTCCTGC	jurkat
mixed_TGTAGGTGTGTCGA	293t
mixed_TGTAGTCTACGGTT	293t
mixed_TGTAGTCTAGCGTT	293t
mixed_TGTAGTCTCAGCTA	293t
mixed_TGTATCTGAACGTC	jurkat
mixed_TGTATCTGATTCGG	293t
mixed_TGTATCTGGGTGAG	293t
mixed_TGTATCTGTCTTAC	293t
mixed_TGTATGCTTAACCG	293t
mixed_TGTCAGGAAGTACC	293t
mixed_TGTCAGGAGAACTC	293t
mixed_TGTCTAACATCACG	jurkat
mixed_TGTCTAACTCCCAC	jurkat
mixed_TGTCTAACTCCTGC	jurkat
mixed_TGTCTAACTCTACT	jurkat
mixed_TGTGACGACCCAAA	jurkat
mixed_TGTGACGACTGTCC	293t
mixed_TGTGACGATCGACA	293t
mixed_TGTGACGATTTCTG	jurkat
mixed_TGTGAGTGCTAGAC	jurkat
mixed_TGTGAGTGGCTAAC	jurkat
mixed_TGTGAGTGGGTATC	293t
mixed_TGTGAGTGTTGCGA	jurkat
mixed_TGTGAGTGTTGTCT	jurkat
mixed_TGTGATCTACCAAC	293t
mixed_TGTGATCTCGCTAA	jurkat
mixed_TGTTAAGAGCGTTA	jurkat
mixed_TGTTAAGAGTCATG	293t
mixed_TGTTAAGATCGCAA	293t
mixed_TGTTACACAGCTCA	jurkat
mixed_TGTTACACCAGAGG	293t
mixed_TGTTACACCCACAA	293t
mixed_TGTTACACCTGAGT	jurkat
mixed_TTAACCACTGAAGA	jurkat
mixed_TTACACACGCGTTA	jurkat
mixed_TTACCATGACGCTA	293t
mixed_TTACCATGGTGTTG	jurkat
mixed_TTACCATGTGGTTG	293t
mixed_TTACGACTAGCAAA	293t
mixed_TTAGAATGATCGAC	293t
mixed_TTAGAATGCGTTGA	293t
mixed_TTAGACCTAACCAC	293t
mixed_TTAGACCTACGGTT	293t
mixed_TTAGCTACCAGTTG	293t
mixed_TTAGCTACTAAAGG	jurkat
mixed_TTAGCTACTAGCGT	jurkat
mixed_TTAGGGACAGCTAC	jurkat
mixed_TTAGGTCTCGCAAT	293t
mixed_TTAGGTCTCTCTCG	293t
mixed_TTAGTCACACAGCT	jurkat
mixed_TTAGTCACACGTGT	293t
mixed_TTAGTCACTAACGC	293t
mixed_TTAGTCTGAGAAGT	jurkat
mixed_TTAGTCTGGTTAGC	293t
mixed_TTATGAGAAAGCAA	jurkat
mixed_TTATGAGAACAGCT	jurkat
mixed_TTATGAGACATTGG	jurkat
mixed_TTATGAGATGATGC	jurkat
mixed_TTATGAGATTTGGG	jurkat
mixed_TTATGCACAAACAG	293t
mixed_TTATGCACGAGCTT	jurkat
mixed_TTATGCACTCCTCG	293t
mixed_TTATGCACTGAGCT	293t
mixed_TTATGGCTTGACTG	jurkat
mixed_TTATGGCTTTCGCC	jurkat
mixed_TTATTCCTGCGTTA	jurkat
mixed_TTATTCCTTCCCAC	293t
mixed_TTCAAAGAACCACA	jurkat
mixed_TTCAACACCACCAA	293t
mixed_TTCAACACCATGCA	jurkat
mixed_TTCAACACCTTCCG	jurkat
mixed_TTCAACACTTCGCC	293t
mixed_TTCAACACTTTGTC	jurkat
mixed_TTCAAGCTCGACTA	293t
mixed_TTCACAACACGCTA	jurkat
mixed_TTCACAACTTCCGC	jurkat
mixed_TTCACCCTCAACCA	293t
mixed_TTCACCCTCTGGAT	jurkat
mixed_TTCACCCTGGCAAG	jurkat
mixed_TTCAGACTCAGATC	jurkat
mixed_TTCAGACTGACGGA	jurkat
mixed_TTCAGACTGTTTGG	jurkat
mixed_TTCAGACTTAAGCC	293t
mixed_TTCAGACTTGAGAA	jurkat
mixed_TTCAGTACAACTGC	jurkat
mixed_TTCATCGACAGGAG	293t
mixed_TTCATGACCTCTAT	jurkat
mixed_TTCATGTGATGTGC	293t
mixed_TTCATTCTCTGATG	jurkat
mixed_TTCATTCTGCGTTA	jurkat
mixed_TTCATTCTGGTTTG	jurkat
mixed_TTCCAAACACACCA	293t
mixed_TTCCAAACCCTACC	jurkat
mixed_TTCCAAACCTCATT	293t
mixed_TTCCAAACGCCATA	293t
mixed_TTCCATGAAGTCGT	293t
mixed_TTCCATGACTTGCC	jurkat
mixed_TTCCATGATGACCA	293t
mixed_TTCCCACTAGTGTC	jurkat
mixed_TTCCCACTCACTAG	jurkat
mixed_TTCCTAGAAAGAAC	293t
mixed_TTCCTAGAACCCTC	jurkat
mixed_TTCCTAGAGATACC	jurkat
mixed_TTCCTAGAGTCTAG	293t
mixed_TTCGAGGAGTGAGG	jurkat
mixed_TTCGAGGATGCCTC	293t
mixed_TTCGATTGAACCAC	jurkat
mixed_TTCGATTGCTGTCC	jurkat
mixed_TTCGATTGGTGTCA	293t
mixed_TTCGGAGAACAGTC	293t
mixed_TTCGGAGAACGCTA	293t
mixed_TTCGGAGACTATTC	jurkat
mixed_TTCGGAGATTCTAC	jurkat
mixed_TTCGTATGCGAGAG	jurkat
mixed_TTCGTATGGGACTT	293t
mixed_TTCGTATGGGTTCA	jurkat
mixed_TTCGTATGTGGAAA	jurkat
mixed_TTCGTATGTTGCAG	jurkat
mixed_TTCTACGAGATGAA	293t
mixed_TTCTACGATAACGC	jurkat
mixed_TTCTAGTGCCATAG	293t
mixed_TTCTCAGATGGAAA	293t
mixed_TTCTGATGAGAACA	293t
mixed_TTCTGATGATTCTC	jurkat
mixed_TTCTGATGCTGTTT	jurkat
mixed_TTCTGATGGAGAGC	jurkat
mixed_TTCTTACTGTTGAC	293t
mixed_TTCTTACTTAAGGA	293t
mixed_TTGAATGAATTCCT	293t
mixed_TTGAATGACTGCAA	jurkat
mixed_TTGACACTCTAGCA	jurkat
mixed_TTGACACTTCCCGT	jurkat
mixed_TTGACACTTCTCAT	jurkat
mixed_TTGACACTTTCTGT	jurkat
mixed_TTGAGGACTCCTCG	293t
mixed_TTGAGGACTTTGCT	jurkat
mixed_TTGAGGTGAGCGGA	293t
mixed_TTGAGGTGGTTCAG	jurkat
mixed_TTGAGGTGTCCCAC	jurkat
mixed_TTGATCTGAGCTAC	jurkat
mixed_TTGATCTGCGTGAT	jurkat
mixed_TTGATCTGCTGACA	293t
mixed_TTGCATTGAGACTC	293t
mixed_TTGCATTGATGCCA	jurkat
mixed_TTGCTAACGTTCGA	jurkat
mixed_TTGGAGTGCCTTCG	293t
mixed_TTGGAGTGTAACGC	293t
mixed_TTGGAGTGTCTCGC	jurkat
mixed_TTGGGAACGCGTAT	293t
mixed_TTGGGAACGTGTCA	jurkat
mixed_TTGGTACTAGCGGA	jurkat
mixed_TTGGTACTGAGAGC	293t
mixed_TTGGTACTGTTGTG	jurkat
mixed_TTGTACACACGACT	jurkat
mixed_TTGTACACGTCTGA	jurkat
mixed_TTGTAGCTATCTTC	jurkat
mixed_TTGTCATGATAAGG	293t
mixed_TTGTCATGCAGTTG	293t
mixed_TTGTCATGTCTTTG	jurkat
mixed_TTTAGAGAATCTTC	jurkat
mixed_TTTAGAGACGATAC	293t
mixed_TTTAGAGAGATGAA	jurkat
mixed_TTTAGAGATACGCA	jurkat
mixed_TTTAGCTGAGCACT	293t
mixed_TTTAGCTGCGGTAT	293t
mixed_TTTAGCTGCTAGAC	jurkat
mixed_TTTAGCTGTGGAAA	jurkat
mixed_TTTAGCTGTGGGAG	293t
mixed_TTTAGCTGTTCCCG	293t
mixed_TTTAGGCTCCTACC	jurkat
mixed_TTTATCCTGCTTCC	293t
mixed_TTTATCCTTCCTAT	jurkat
mixed_TTTATCCTTCTAGG	jurkat
mixed_TTTATCCTTGTTTC	293t
mixed_TTTCACGAAGCAAA	293t
mixed_TTTCACGACGTGTA	jurkat
mixed_TTTCACGAGTCATG	jurkat
mixed_TTTCACGAGTCTGA	jurkat
mixed_TTTCACGAGTGTTG	jurkat
mixed_TTTCAGTGCGCCTT	jurkat
mixed_TTTCAGTGTGACAC	jurkat
mixed_TTTCCAGACCTCAC	jurkat
mixed_TTTCCAGAGCTGTA	293t
mixed_TTTCGAACATACCG	jurkat
mixed_TTTCGAACGAACTC	293t
mixed_TTTCTACTAACGAA	jurkat
mixed_TTTCTACTGTCTAG	jurkat
mixed_TTTGACTGCCCTCA	jurkat
mixed_TTTGACTGTCATTC	jurkat
mixed_TTTGACTGTGGGAG	293t
mixed_TTTGCATGAGATCC	293t
mixed_TTTGCATGCTCATT	293t
mixed_TTTGCATGTTGTCT	jurkat
